	ant_genome.fa.transdecoder	chicken_genome.fa.transdecoder	oyster_transcriptome.fa.transdecoder	salmon_transcriptome.fa.transdecoder	sponge_transcriptome.fa.transdecoder	Total
OG0000000	0	0	570	0	9	579
OG0000001	18	22	301	201	4	546
OG0000002	9	94	15	396	2	516
OG0000003	33	133	128	196	0	490
OG0000004	219	0	143	37	29	428
OG0000005	48	13	122	115	106	404
OG0000006	3	41	187	76	10	317
OG0000007	45	62	59	139	1	306
OG0000008	0	0	304	0	0	304
OG0000009	23	71	64	104	2	264
OG0000010	7	106	18	129	1	261
OG0000011	0	247	0	3	0	250
OG0000012	0	4	0	228	15	247
OG0000013	9	64	19	123	19	234
OG0000014	16	42	103	68	0	229
OG0000015	0	0	0	221	0	221
OG0000016	13	66	10	117	1	207
OG0000017	7	58	26	114	1	206
OG0000018	37	67	21	76	1	202
OG0000019	0	0	197	0	0	197
OG0000020	32	53	21	89	1	196
OG0000021	40	59	25	70	2	196
OG0000022	14	42	1	135	1	193
OG0000023	18	101	42	30	1	192
OG0000024	8	141	13	3	22	187
OG0000025	8	32	15	117	3	175
OG0000026	4	68	10	91	0	173
OG0000027	13	67	1	90	1	172
OG0000028	6	6	57	10	93	172
OG0000029	1	7	106	1	50	165
OG0000030	8	35	24	80	13	160
OG0000031	4	31	17	102	1	155
OG0000032	4	39	2	102	0	147
OG0000033	14	63	23	47	0	147
OG0000034	7	48	11	77	2	145
OG0000035	3	51	9	80	1	144
OG0000036	20	42	7	71	2	142
OG0000037	2	83	4	49	1	139
OG0000038	5	14	28	61	28	136
OG0000039	0	1	7	127	0	135
OG0000040	4	37	11	79	1	132
OG0000041	2	26	17	86	1	132
OG0000042	0	18	0	111	3	132
OG0000043	0	52	0	79	0	131
OG0000044	6	43	56	23	0	128
OG0000045	6	29	25	68	0	128
OG0000046	0	50	35	36	7	128
OG0000047	6	0	26	87	7	126
OG0000048	5	47	7	65	1	125
OG0000049	7	39	1	77	1	125
OG0000050	11	52	14	45	1	123
OG0000051	43	51	17	12	0	123
OG0000052	1	1	85	19	17	123
OG0000053	36	24	26	35	1	122
OG0000054	16	32	5	65	2	120
OG0000055	8	30	6	74	1	119
OG0000056	10	36	11	59	1	117
OG0000057	4	64	12	35	2	117
OG0000058	6	24	21	48	17	116
OG0000059	14	31	12	58	1	116
OG0000060	5	26	11	74	0	116
OG0000061	10	57	14	33	1	115
OG0000062	73	6	5	21	10	115
OG0000063	6	58	1	49	1	115
OG0000064	9	28	31	46	1	115
OG0000065	0	11	66	38	0	115
OG0000066	21	22	1	69	1	114
OG0000067	5	46	20	41	1	113
OG0000068	0	24	38	50	1	113
OG0000069	0	0	88	0	25	113
OG0000070	3	42	12	53	1	111
OG0000071	6	35	13	53	3	110
OG0000072	9	34	4	62	1	110
OG0000073	0	42	0	68	0	110
OG0000074	21	24	27	24	13	109
OG0000075	1	0	77	18	13	109
OG0000076	0	51	6	51	0	108
OG0000077	2	12	14	78	1	107
OG0000078	14	53	4	31	4	106
OG0000079	20	39	5	38	3	105
OG0000080	5	63	2	35	0	105
OG0000081	18	28	2	55	1	104
OG0000082	8	34	4	55	3	104
OG0000083	0	92	7	4	0	103
OG0000084	3	23	33	41	2	102
OG0000085	11	18	6	65	2	102
OG0000086	50	6	4	40	0	100
OG0000087	0	5	0	94	0	99
OG0000088	22	0	63	0	13	98
OG0000089	0	0	98	0	0	98
OG0000090	7	42	10	37	1	97
OG0000091	8	12	21	55	1	97
OG0000092	14	36	3	43	1	97
OG0000093	11	39	13	33	1	97
OG0000094	21	13	15	45	1	95
OG0000095	12	8	41	34	0	95
OG0000096	7	22	12	51	2	94
OG0000097	21	30	21	17	4	93
OG0000098	9	26	7	50	1	93
OG0000099	3	33	14	40	3	93
OG0000100	14	22	10	46	1	93
OG0000101	3	0	61	28	1	93
OG0000102	0	0	0	93	0	93
OG0000103	13	17	24	37	1	92
OG0000104	4	40	4	44	0	92
OG0000105	6	21	5	58	2	92
OG0000106	7	34	16	33	1	91
OG0000107	14	23	7	46	1	91
OG0000108	0	85	1	5	0	91
OG0000109	0	0	90	0	1	91
OG0000110	7	34	8	40	1	90
OG0000111	9	20	6	52	3	90
OG0000112	0	1	0	89	0	90
OG0000113	5	36	24	23	1	89
OG0000114	8	23	4	53	1	89
OG0000115	8	22	42	14	3	89
OG0000116	39	28	7	12	3	89
OG0000117	7	38	12	30	1	88
OG0000118	1	24	21	10	32	88
OG0000119	4	24	14	36	10	88
OG0000120	0	88	0	0	0	88
OG0000121	9	39	11	28	0	87
OG0000122	16	40	5	25	1	87
OG0000123	0	57	0	30	0	87
OG0000124	0	2	0	85	0	87
OG0000125	2	21	23	40	0	86
OG0000126	2	3	78	1	2	86
OG0000127	24	38	11	8	5	86
OG0000128	1	22	29	31	3	86
OG0000129	4	23	10	47	1	85
OG0000130	2	78	3	2	0	85
OG0000131	6	13	11	53	1	84
OG0000132	3	23	5	51	2	84
OG0000133	1	22	8	52	1	84
OG0000134	8	22	14	39	0	83
OG0000135	0	0	83	0	0	83
OG0000136	5	11	23	42	1	82
OG0000137	3	22	21	30	6	82
OG0000138	11	7	6	57	0	81
OG0000139	7	22	2	49	1	81
OG0000140	2	35	18	25	0	80
OG0000141	2	18	1	56	3	80
OG0000142	17	0	62	0	0	79
OG0000143	29	6	18	16	10	79
OG0000144	11	25	20	22	1	79
OG0000145	6	48	6	16	3	79
OG0000146	14	44	1	17	3	79
OG0000147	2	37	11	22	7	79
OG0000148	3	31	5	39	0	78
OG0000149	11	18	19	28	2	78
OG0000150	9	12	26	27	4	78
OG0000151	48	1	27	0	2	78
OG0000152	31	16	0	31	0	78
OG0000153	6	25	7	39	1	78
OG0000154	9	17	6	44	1	77
OG0000155	7	16	31	22	1	77
OG0000156	14	59	1	1	2	77
OG0000157	39	12	19	6	1	77
OG0000158	9	29	20	17	1	76
OG0000159	4	28	4	40	0	76
OG0000160	1	5	61	0	9	76
OG0000161	10	31	2	32	1	76
OG0000162	6	11	5	54	0	76
OG0000163	2	25	8	40	1	76
OG0000164	0	0	0	76	0	76
OG0000165	17	17	1	39	1	75
OG0000166	4	41	12	17	1	75
OG0000167	7	23	5	38	1	74
OG0000168	2	20	14	37	1	74
OG0000169	7	33	8	25	0	73
OG0000170	4	3	5	60	1	73
OG0000171	1	26	1	44	1	73
OG0000172	5	13	31	18	6	73
OG0000173	11	24	13	12	13	73
OG0000174	5	30	6	31	1	73
OG0000175	7	11	50	5	0	73
OG0000176	0	10	42	0	21	73
OG0000177	15	23	4	29	1	72
OG0000178	21	32	11	7	1	72
OG0000179	7	3	47	3	11	71
OG0000180	9	13	8	40	1	71
OG0000181	5	19	25	21	1	71
OG0000182	50	0	11	3	6	70
OG0000183	3	53	8	6	0	70
OG0000184	6	19	5	38	2	70
OG0000185	4	24	21	20	1	70
OG0000186	8	28	24	6	4	70
OG0000187	1	16	16	36	1	70
OG0000188	0	20	19	30	1	70
OG0000189	0	29	5	36	0	70
OG0000190	8	20	10	25	6	69
OG0000191	3	45	5	14	2	69
OG0000192	3	12	4	48	2	69
OG0000193	1	15	18	34	1	69
OG0000194	2	33	8	25	1	69
OG0000195	6	14	2	46	1	69
OG0000196	5	14	8	41	0	68
OG0000197	10	13	7	36	2	68
OG0000198	9	11	8	25	15	68
OG0000199	7	13	13	30	5	68
OG0000200	1	14	9	43	1	68
OG0000201	1	42	7	18	0	68
OG0000202	0	31	7	30	0	68
OG0000203	61	2	4	0	0	67
OG0000204	8	15	14	29	1	67
OG0000205	9	9	19	29	1	67
OG0000206	0	25	2	40	0	67
OG0000207	0	24	1	40	2	67
OG0000208	3	4	45	14	0	66
OG0000209	8	17	6	35	0	66
OG0000210	1	31	22	12	0	66
OG0000211	6	25	14	13	7	65
OG0000212	5	16	11	31	2	65
OG0000213	4	10	10	38	3	65
OG0000214	7	24	3	30	1	65
OG0000215	6	12	4	42	1	65
OG0000216	30	2	28	1	3	64
OG0000217	3	18	9	31	3	64
OG0000218	15	16	12	19	2	64
OG0000219	10	22	1	28	2	63
OG0000220	3	23	3	31	3	63
OG0000221	7	16	9	30	1	63
OG0000222	12	17	16	18	0	63
OG0000223	5	27	12	17	2	63
OG0000224	1	15	12	34	1	63
OG0000225	5	19	17	20	1	62
OG0000226	3	15	9	35	0	62
OG0000227	1	20	12	28	1	62
OG0000228	6	16	11	29	0	62
OG0000229	10	2	43	4	3	62
OG0000230	11	11	7	32	1	62
OG0000231	9	10	32	8	2	61
OG0000232	8	24	12	16	1	61
OG0000233	6	13	5	37	0	61
OG0000234	1	15	19	23	3	61
OG0000235	15	4	20	17	5	61
OG0000236	1	19	6	34	1	61
OG0000237	6	12	26	8	9	61
OG0000238	2	9	4	44	2	61
OG0000239	7	12	14	25	3	61
OG0000240	44	0	5	1	11	61
OG0000241	18	11	19	12	1	61
OG0000242	0	36	12	11	2	61
OG0000243	0	34	3	23	1	61
OG0000244	0	31	1	29	0	61
OG0000245	0	2	1	58	0	61
OG0000246	4	24	5	26	1	60
OG0000247	1	22	7	30	0	60
OG0000248	4	8	18	26	4	60
OG0000249	7	15	4	32	2	60
OG0000250	4	16	1	38	1	60
OG0000251	21	26	1	11	1	60
OG0000252	6	13	9	31	1	60
OG0000253	8	21	6	24	1	60
OG0000254	15	22	18	5	0	60
OG0000255	0	15	0	44	1	60
OG0000256	0	8	1	51	0	60
OG0000257	0	26	0	34	0	60
OG0000258	0	58	0	1	1	60
OG0000259	5	9	6	39	0	59
OG0000260	4	24	7	23	1	59
OG0000261	5	8	13	32	1	59
OG0000262	5	5	29	11	9	59
OG0000263	5	14	11	29	0	59
OG0000264	11	18	12	16	2	59
OG0000265	4	17	6	31	1	59
OG0000266	11	22	14	11	1	59
OG0000267	5	34	4	15	1	59
OG0000268	0	10	0	49	0	59
OG0000269	0	15	8	27	9	59
OG0000270	0	29	19	9	2	59
OG0000271	8	17	7	24	2	58
OG0000272	2	19	27	9	1	58
OG0000273	8	16	7	26	1	58
OG0000274	6	9	16	24	3	58
OG0000275	16	14	11	16	1	58
OG0000276	10	19	2	26	1	58
OG0000277	6	40	7	3	1	57
OG0000278	1	24	2	30	0	57
OG0000279	3	18	4	31	1	57
OG0000280	9	0	48	0	0	57
OG0000281	3	8	5	40	1	57
OG0000282	5	18	5	28	1	57
OG0000283	0	15	20	21	1	57
OG0000284	0	1	41	11	4	57
OG0000285	0	29	4	22	2	57
OG0000286	5	10	4	35	2	56
OG0000287	9	10	20	16	1	56
OG0000288	6	2	8	35	5	56
OG0000289	6	26	7	13	4	56
OG0000290	18	14	11	12	1	56
OG0000291	2	12	3	33	6	56
OG0000292	4	30	5	16	1	56
OG0000293	7	0	47	2	0	56
OG0000294	1	21	11	23	0	56
OG0000295	5	16	5	29	1	56
OG0000296	4	15	2	33	2	56
OG0000297	0	10	3	32	11	56
OG0000298	0	0	55	0	1	56
OG0000299	0	0	0	56	0	56
OG0000300	7	13	25	6	4	55
OG0000301	13	9	13	19	1	55
OG0000302	18	4	20	10	3	55
OG0000303	1	20	10	22	2	55
OG0000304	3	18	2	31	1	55
OG0000305	1	11	22	15	6	55
OG0000306	25	1	6	22	1	55
OG0000307	8	31	8	6	2	55
OG0000308	1	7	1	44	1	54
OG0000309	4	15	7	27	1	54
OG0000310	2	11	4	36	1	54
OG0000311	1	16	7	28	2	54
OG0000312	12	8	10	23	1	54
OG0000313	7	16	6	24	1	54
OG0000314	14	8	15	10	7	54
OG0000315	4	6	2	41	1	54
OG0000316	2	25	1	25	1	54
OG0000317	11	18	5	19	1	54
OG0000318	1	15	21	17	0	54
OG0000319	0	16	6	31	1	54
OG0000320	6	27	9	10	1	53
OG0000321	8	23	15	6	1	53
OG0000322	4	0	38	9	2	53
OG0000323	7	16	3	26	1	53
OG0000324	14	1	5	2	31	53
OG0000325	2	11	3	36	1	53
OG0000326	23	3	7	19	1	53
OG0000327	3	15	4	29	2	53
OG0000328	2	18	4	26	3	53
OG0000329	2	10	17	24	0	53
OG0000330	8	21	10	12	2	53
OG0000331	2	0	47	2	2	53
OG0000332	0	1	51	0	1	53
OG0000333	3	12	6	30	1	52
OG0000334	11	12	8	18	3	52
OG0000335	1	6	24	14	7	52
OG0000336	2	14	8	27	1	52
OG0000337	12	26	5	9	0	52
OG0000338	15	2	14	20	1	52
OG0000339	18	12	2	20	0	52
OG0000340	3	9	1	37	2	52
OG0000341	10	19	5	17	1	52
OG0000342	3	16	7	26	0	52
OG0000343	2	19	9	20	2	52
OG0000344	4	17	7	23	1	52
OG0000345	3	20	10	19	0	52
OG0000346	3	9	7	32	1	52
OG0000347	0	43	3	4	2	52
OG0000348	0	32	3	15	2	52
OG0000349	0	1	0	1	50	52
OG0000350	0	1	34	3	14	52
OG0000351	4	22	1	23	1	51
OG0000352	1	12	1	37	0	51
OG0000353	6	17	18	9	1	51
OG0000354	10	23	11	5	2	51
OG0000355	4	14	4	28	1	51
OG0000356	2	9	4	31	5	51
OG0000357	7	13	2	28	1	51
OG0000358	3	14	32	1	1	51
OG0000359	2	20	5	23	1	51
OG0000360	4	11	8	26	2	51
OG0000361	4	28	12	6	1	51
OG0000362	1	7	35	6	2	51
OG0000363	3	22	1	25	0	51
OG0000364	0	9	29	11	2	51
OG0000365	0	12	0	39	0	51
OG0000366	0	0	38	3	10	51
OG0000367	0	0	0	0	51	51
OG0000368	11	7	19	10	3	50
OG0000369	2	21	10	16	1	50
OG0000370	3	2	4	40	1	50
OG0000371	7	11	7	24	1	50
OG0000372	5	11	12	21	1	50
OG0000373	7	34	3	6	0	50
OG0000374	0	15	21	11	3	50
OG0000375	0	37	13	0	0	50
OG0000376	0	50	0	0	0	50
OG0000377	0	0	0	50	0	50
OG0000378	2	24	1	21	1	49
OG0000379	10	14	14	7	4	49
OG0000380	7	8	5	29	0	49
OG0000381	8	5	27	9	0	49
OG0000382	2	19	2	25	1	49
OG0000383	6	17	3	22	1	49
OG0000384	2	16	3	27	1	49
OG0000385	4	11	5	28	1	49
OG0000386	12	13	8	13	3	49
OG0000387	13	8	21	6	1	49
OG0000388	5	12	2	27	3	49
OG0000389	0	7	6	36	0	49
OG0000390	0	3	1	45	0	49
OG0000391	0	0	28	11	10	49
OG0000392	3	21	2	20	2	48
OG0000393	5	30	12	1	0	48
OG0000394	13	8	7	19	1	48
OG0000395	3	27	9	7	2	48
OG0000396	1	12	19	13	3	48
OG0000397	10	15	12	11	0	48
OG0000398	9	16	11	9	3	48
OG0000399	12	30	3	2	1	48
OG0000400	2	21	2	21	2	48
OG0000401	5	6	26	9	2	48
OG0000402	3	7	20	17	1	48
OG0000403	9	25	4	9	1	48
OG0000404	2	20	6	19	1	48
OG0000405	0	17	3	27	1	48
OG0000406	0	18	1	29	0	48
OG0000407	0	12	0	36	0	48
OG0000408	11	9	14	12	1	47
OG0000409	3	9	1	33	1	47
OG0000410	5	13	4	24	1	47
OG0000411	3	19	6	18	1	47
OG0000412	3	22	3	18	1	47
OG0000413	7	15	14	10	1	47
OG0000414	11	20	11	4	1	47
OG0000415	8	18	4	16	1	47
OG0000416	4	1	23	12	7	47
OG0000417	1	16	0	29	1	47
OG0000418	4	16	17	10	0	47
OG0000419	0	37	10	0	0	47
OG0000420	0	39	1	7	0	47
OG0000421	0	16	1	30	0	47
OG0000422	11	28	4	2	1	46
OG0000423	11	9	20	6	0	46
OG0000424	7	23	4	11	1	46
OG0000425	15	12	14	4	1	46
OG0000426	7	14	9	14	2	46
OG0000427	1	14	1	29	1	46
OG0000428	7	6	21	11	1	46
OG0000429	2	9	1	33	1	46
OG0000430	1	17	5	22	1	46
OG0000431	9	26	5	5	1	46
OG0000432	4	13	7	20	2	46
OG0000433	5	13	8	19	1	46
OG0000434	16	16	10	4	0	46
OG0000435	13	9	4	20	0	46
OG0000436	3	22	2	19	0	46
OG0000437	7	10	4	24	1	46
OG0000438	4	5	12	24	1	46
OG0000439	3	18	3	20	2	46
OG0000440	8	8	4	25	1	46
OG0000441	1	6	14	24	1	46
OG0000442	1	2	17	26	0	46
OG0000443	1	32	3	10	0	46
OG0000444	6	14	10	15	1	46
OG0000445	1	2	1	40	2	46
OG0000446	0	24	0	22	0	46
OG0000447	0	13	10	22	1	46
OG0000448	0	18	6	20	2	46
OG0000449	0	20	10	15	1	46
OG0000450	0	1	19	8	18	46
OG0000451	6	5	5	23	6	45
OG0000452	11	13	3	17	1	45
OG0000453	1	7	10	26	1	45
OG0000454	2	17	2	23	1	45
OG0000455	4	10	10	20	1	45
OG0000456	2	12	9	21	1	45
OG0000457	6	17	10	11	1	45
OG0000458	3	5	16	12	9	45
OG0000459	5	18	1	21	0	45
OG0000460	6	13	7	17	2	45
OG0000461	2	15	6	21	1	45
OG0000462	7	22	11	4	1	45
OG0000463	12	12	10	9	2	45
OG0000464	15	5	3	22	0	45
OG0000465	2	13	8	22	0	45
OG0000466	2	9	21	10	3	45
OG0000467	6	9	19	10	1	45
OG0000468	0	2	9	33	1	45
OG0000469	0	19	4	22	0	45
OG0000470	0	31	3	11	0	45
OG0000471	0	0	44	0	1	45
OG0000472	6	10	5	20	3	44
OG0000473	3	16	0	24	1	44
OG0000474	4	4	19	15	2	44
OG0000475	1	7	9	21	6	44
OG0000476	2	20	9	12	1	44
OG0000477	4	14	7	13	6	44
OG0000478	8	13	5	17	1	44
OG0000479	31	6	2	4	1	44
OG0000480	2	10	1	30	1	44
OG0000481	9	12	8	13	2	44
OG0000482	9	7	8	8	12	44
OG0000483	4	20	7	10	3	44
OG0000484	5	16	7	14	2	44
OG0000485	2	14	1	27	0	44
OG0000486	10	18	4	11	1	44
OG0000487	5	12	2	24	1	44
OG0000488	3	18	2	20	1	44
OG0000489	3	27	3	10	1	44
OG0000490	2	8	12	21	1	44
OG0000491	6	18	5	15	0	44
OG0000492	5	9	2	28	0	44
OG0000493	3	28	5	8	0	44
OG0000494	0	2	31	11	0	44
OG0000495	0	0	0	44	0	44
OG0000496	1	1	26	15	0	43
OG0000497	11	11	12	9	0	43
OG0000498	3	9	25	6	0	43
OG0000499	1	14	2	25	1	43
OG0000500	10	7	4	22	0	43
OG0000501	4	22	1	16	0	43
OG0000502	4	12	5	21	1	43
OG0000503	7	19	7	9	1	43
OG0000504	4	4	15	20	0	43
OG0000505	2	22	2	17	0	43
OG0000506	5	10	8	19	1	43
OG0000507	3	13	6	21	0	43
OG0000508	6	4	5	26	2	43
OG0000509	7	27	4	4	1	43
OG0000510	2	15	2	23	1	43
OG0000511	5	12	1	24	1	43
OG0000512	1	6	24	11	1	43
OG0000513	2	15	2	23	1	43
OG0000514	11	19	1	10	2	43
OG0000515	8	11	4	16	4	43
OG0000516	8	26	6	2	1	43
OG0000517	0	10	10	19	4	43
OG0000518	0	1	8	33	1	43
OG0000519	0	0	43	0	0	43
OG0000520	0	0	1	42	0	43
OG0000521	0	0	0	42	1	43
OG0000522	6	10	4	21	1	42
OG0000523	5	27	3	7	0	42
OG0000524	6	8	8	20	0	42
OG0000525	2	10	15	13	2	42
OG0000526	24	3	3	10	2	42
OG0000527	11	7	20	4	0	42
OG0000528	4	23	2	12	1	42
OG0000529	8	7	15	12	0	42
OG0000530	3	14	3	19	3	42
OG0000531	5	4	12	19	2	42
OG0000532	10	15	1	15	1	42
OG0000533	3	10	3	26	0	42
OG0000534	8	6	6	22	0	42
OG0000535	5	6	3	28	0	42
OG0000536	5	5	11	20	1	42
OG0000537	0	16	1	24	1	42
OG0000538	0	1	4	7	30	42
OG0000539	0	24	6	11	1	42
OG0000540	0	4	6	4	28	42
OG0000541	0	25	0	17	0	42
OG0000542	7	15	2	16	1	41
OG0000543	4	14	4	18	1	41
OG0000544	41	0	0	0	0	41
OG0000545	7	10	10	7	7	41
OG0000546	6	14	7	12	2	41
OG0000547	9	7	12	12	1	41
OG0000548	4	17	3	16	1	41
OG0000549	7	11	6	16	1	41
OG0000550	6	23	4	7	1	41
OG0000551	1	9	3	27	1	41
OG0000552	1	11	3	24	2	41
OG0000553	3	11	2	24	1	41
OG0000554	2	8	15	7	9	41
OG0000555	1	9	2	29	0	41
OG0000556	2	14	5	19	1	41
OG0000557	11	13	1	15	1	41
OG0000558	1	16	4	19	1	41
OG0000559	5	21	3	12	0	41
OG0000560	3	19	9	5	5	41
OG0000561	6	5	2	25	3	41
OG0000562	2	16	2	20	1	41
OG0000563	3	9	5	24	0	41
OG0000564	7	15	4	14	1	41
OG0000565	4	8	4	25	0	41
OG0000566	0	16	1	22	2	41
OG0000567	0	12	0	29	0	41
OG0000568	0	0	41	0	0	41
OG0000569	2	19	6	12	1	40
OG0000570	2	6	18	13	1	40
OG0000571	1	13	2	21	3	40
OG0000572	8	10	6	15	1	40
OG0000573	1	12	4	23	0	40
OG0000574	3	5	6	24	2	40
OG0000575	2	12	8	17	1	40
OG0000576	3	12	14	11	0	40
OG0000577	7	9	11	13	0	40
OG0000578	8	4	22	6	0	40
OG0000579	2	0	38	0	0	40
OG0000580	4	14	1	19	2	40
OG0000581	6	14	1	19	0	40
OG0000582	3	16	2	19	0	40
OG0000583	6	14	2	16	2	40
OG0000584	6	6	14	14	0	40
OG0000585	2	13	6	19	0	40
OG0000586	12	10	8	9	1	40
OG0000587	1	6	29	3	1	40
OG0000588	6	20	3	10	1	40
OG0000589	2	16	2	20	0	40
OG0000590	1	6	11	21	1	40
OG0000591	2	9	4	25	0	40
OG0000592	3	16	1	19	1	40
OG0000593	0	14	0	25	1	40
OG0000594	0	20	18	2	0	40
OG0000595	0	4	8	28	0	40
OG0000596	3	16	2	17	1	39
OG0000597	2	11	12	12	2	39
OG0000598	6	16	5	12	0	39
OG0000599	1	24	1	12	1	39
OG0000600	7	0	32	0	0	39
OG0000601	4	22	5	6	2	39
OG0000602	8	13	6	11	1	39
OG0000603	2	8	5	23	1	39
OG0000604	21	2	13	3	0	39
OG0000605	1	6	29	2	1	39
OG0000606	9	9	11	10	0	39
OG0000607	2	14	16	7	0	39
OG0000608	14	8	16	0	1	39
OG0000609	1	13	1	23	1	39
OG0000610	4	6	9	19	1	39
OG0000611	1	21	3	14	0	39
OG0000612	4	21	1	12	1	39
OG0000613	6	11	6	15	1	39
OG0000614	5	9	5	20	0	39
OG0000615	11	2	6	20	0	39
OG0000616	2	5	6	2	24	39
OG0000617	2	0	1	25	11	39
OG0000618	1	7	7	23	1	39
OG0000619	2	0	19	16	2	39
OG0000620	11	18	5	4	1	39
OG0000621	0	18	0	21	0	39
OG0000622	0	11	2	25	1	39
OG0000623	0	14	0	23	2	39
OG0000624	0	16	0	23	0	39
OG0000625	0	32	4	0	3	39
OG0000626	0	6	8	5	20	39
OG0000627	2	22	6	7	1	38
OG0000628	8	12	3	14	1	38
OG0000629	13	5	3	17	0	38
OG0000630	8	11	3	14	2	38
OG0000631	5	5	2	25	1	38
OG0000632	7	17	9	4	1	38
OG0000633	3	5	2	27	1	38
OG0000634	3	21	11	3	0	38
OG0000635	4	15	5	13	1	38
OG0000636	1	15	2	19	1	38
OG0000637	3	4	3	28	0	38
OG0000638	1	4	1	32	0	38
OG0000639	2	11	3	21	1	38
OG0000640	4	12	5	14	3	38
OG0000641	4	11	7	12	4	38
OG0000642	3	9	4	21	1	38
OG0000643	30	1	3	3	1	38
OG0000644	6	17	2	12	1	38
OG0000645	10	11	7	9	1	38
OG0000646	12	14	5	7	0	38
OG0000647	1	8	5	24	0	38
OG0000648	8	11	9	9	1	38
OG0000649	3	9	7	16	3	38
OG0000650	1	13	3	20	1	38
OG0000651	4	10	5	18	1	38
OG0000652	6	18	6	7	1	38
OG0000653	0	16	6	14	2	38
OG0000654	0	8	6	23	1	38
OG0000655	0	15	0	23	0	38
OG0000656	0	1	7	26	4	38
OG0000657	2	13	4	17	1	37
OG0000658	2	6	6	22	1	37
OG0000659	5	6	11	11	4	37
OG0000660	3	10	5	17	2	37
OG0000661	3	11	7	13	3	37
OG0000662	5	22	4	5	1	37
OG0000663	2	10	9	15	1	37
OG0000664	2	9	3	23	0	37
OG0000665	3	11	2	21	0	37
OG0000666	2	15	2	18	0	37
OG0000667	3	5	4	23	2	37
OG0000668	2	15	7	12	1	37
OG0000669	6	30	0	0	1	37
OG0000670	1	14	15	7	0	37
OG0000671	7	26	1	3	0	37
OG0000672	3	14	12	7	1	37
OG0000673	2	8	17	10	0	37
OG0000674	9	7	3	17	1	37
OG0000675	2	8	7	19	1	37
OG0000676	1	8	4	24	0	37
OG0000677	7	9	4	16	1	37
OG0000678	6	12	6	13	0	37
OG0000679	8	15	1	12	1	37
OG0000680	8	23	1	4	1	37
OG0000681	3	14	2	17	1	37
OG0000682	5	5	11	16	0	37
OG0000683	3	15	3	16	0	37
OG0000684	1	23	7	5	1	37
OG0000685	2	10	1	22	2	37
OG0000686	0	0	37	0	0	37
OG0000687	7	2	3	11	13	36
OG0000688	2	16	5	12	1	36
OG0000689	1	10	0	24	1	36
OG0000690	3	15	8	7	3	36
OG0000691	1	20	7	8	0	36
OG0000692	1	7	10	16	2	36
OG0000693	4	2	15	14	1	36
OG0000694	3	5	3	24	1	36
OG0000695	2	24	2	7	1	36
OG0000696	8	3	12	11	2	36
OG0000697	1	9	2	23	1	36
OG0000698	3	13	8	11	1	36
OG0000699	4	9	17	5	1	36
OG0000700	1	23	6	5	1	36
OG0000701	3	15	12	5	1	36
OG0000702	2	13	3	18	0	36
OG0000703	5	10	4	16	1	36
OG0000704	7	8	5	15	1	36
OG0000705	5	20	1	9	1	36
OG0000706	3	14	2	16	1	36
OG0000707	2	7	2	25	0	36
OG0000708	6	11	4	10	5	36
OG0000709	1	15	1	18	1	36
OG0000710	3	7	13	10	3	36
OG0000711	3	14	14	4	1	36
OG0000712	2	14	4	14	2	36
OG0000713	0	8	11	17	0	36
OG0000714	0	14	5	16	1	36
OG0000715	0	15	1	19	1	36
OG0000716	0	23	0	13	0	36
OG0000717	0	0	36	0	0	36
OG0000718	0	0	34	2	0	36
OG0000719	4	10	12	7	2	35
OG0000720	2	16	4	11	2	35
OG0000721	9	3	16	3	4	35
OG0000722	4	5	3	19	4	35
OG0000723	3	3	21	7	1	35
OG0000724	5	11	14	4	1	35
OG0000725	5	6	8	14	2	35
OG0000726	3	4	2	25	1	35
OG0000727	4	9	8	13	1	35
OG0000728	2	15	3	14	1	35
OG0000729	1	17	2	13	2	35
OG0000730	1	11	2	20	1	35
OG0000731	7	10	8	10	0	35
OG0000732	1	14	1	17	2	35
OG0000733	1	5	2	27	0	35
OG0000734	2	8	2	22	1	35
OG0000735	2	9	3	19	2	35
OG0000736	15	18	0	0	2	35
OG0000737	4	11	10	10	0	35
OG0000738	5	14	2	14	0	35
OG0000739	10	4	11	9	1	35
OG0000740	1	6	12	14	2	35
OG0000741	2	5	2	25	1	35
OG0000742	4	8	1	21	1	35
OG0000743	1	12	1	20	1	35
OG0000744	1	8	11	14	1	35
OG0000745	1	10	15	8	1	35
OG0000746	6	11	4	13	1	35
OG0000747	3	7	7	18	0	35
OG0000748	8	0	19	0	8	35
OG0000749	3	8	4	19	1	35
OG0000750	5	5	19	5	1	35
OG0000751	3	12	3	16	1	35
OG0000752	0	8	3	22	2	35
OG0000753	0	17	2	14	2	35
OG0000754	0	14	11	8	2	35
OG0000755	0	14	10	11	0	35
OG0000756	0	5	1	29	0	35
OG0000757	0	21	2	11	1	35
OG0000758	0	9	2	23	1	35
OG0000759	0	0	15	11	9	35
OG0000760	0	0	2	0	33	35
OG0000761	4	13	5	10	2	34
OG0000762	5	13	8	7	1	34
OG0000763	2	10	8	13	1	34
OG0000764	4	4	3	21	2	34
OG0000765	2	15	2	14	1	34
OG0000766	4	17	2	10	1	34
OG0000767	1	12	1	19	1	34
OG0000768	2	5	3	23	1	34
OG0000769	6	14	3	10	1	34
OG0000770	4	4	9	14	3	34
OG0000771	9	12	8	4	1	34
OG0000772	12	14	4	2	2	34
OG0000773	7	6	0	18	3	34
OG0000774	5	5	12	11	1	34
OG0000775	2	11	2	17	2	34
OG0000776	1	7	6	18	2	34
OG0000777	4	10	8	11	1	34
OG0000778	6	7	2	16	3	34
OG0000779	3	3	2	25	1	34
OG0000780	10	7	14	2	1	34
OG0000781	1	1	5	24	3	34
OG0000782	1	12	1	19	1	34
OG0000783	8	12	11	3	0	34
OG0000784	2	6	1	23	2	34
OG0000785	3	5	1	23	2	34
OG0000786	1	16	7	9	1	34
OG0000787	5	13	10	4	2	34
OG0000788	3	5	15	9	2	34
OG0000789	2	12	4	15	1	34
OG0000790	1	15	3	13	2	34
OG0000791	6	13	5	9	1	34
OG0000792	11	6	5	11	1	34
OG0000793	0	20	4	10	0	34
OG0000794	0	13	1	20	0	34
OG0000795	0	5	19	9	1	34
OG0000796	0	7	4	23	0	34
OG0000797	0	11	0	23	0	34
OG0000798	0	0	34	0	0	34
OG0000799	0	0	0	33	1	34
OG0000800	0	0	0	34	0	34
OG0000801	5	6	9	6	7	33
OG0000802	1	28	1	2	1	33
OG0000803	2	9	3	18	1	33
OG0000804	14	6	8	4	1	33
OG0000805	6	7	3	16	1	33
OG0000806	1	11	3	17	1	33
OG0000807	10	11	7	3	2	33
OG0000808	4	14	9	6	0	33
OG0000809	3	13	4	12	1	33
OG0000810	1	8	4	18	2	33
OG0000811	2	19	2	9	1	33
OG0000812	7	11	1	13	1	33
OG0000813	1	7	10	14	1	33
OG0000814	1	10	4	17	1	33
OG0000815	5	14	4	9	1	33
OG0000816	11	1	18	2	1	33
OG0000817	2	5	1	24	1	33
OG0000818	2	4	11	15	1	33
OG0000819	5	5	7	12	4	33
OG0000820	5	23	1	3	1	33
OG0000821	4	13	3	12	1	33
OG0000822	14	0	19	0	0	33
OG0000823	4	22	0	7	0	33
OG0000824	4	13	10	6	0	33
OG0000825	1	0	2	30	0	33
OG0000826	15	3	5	10	0	33
OG0000827	4	21	2	4	2	33
OG0000828	1	8	6	16	2	33
OG0000829	2	5	5	4	17	33
OG0000830	0	7	9	17	0	33
OG0000831	0	8	2	23	0	33
OG0000832	0	12	5	13	3	33
OG0000833	0	5	13	13	2	33
OG0000834	0	5	0	27	1	33
OG0000835	0	3	1	27	2	33
OG0000836	0	8	5	20	0	33
OG0000837	0	8	0	20	5	33
OG0000838	0	14	7	11	1	33
OG0000839	0	7	1	25	0	33
OG0000840	0	0	1	32	0	33
OG0000841	0	0	0	0	33	33
OG0000842	6	8	5	11	2	32
OG0000843	1	20	1	9	1	32
OG0000844	4	16	7	5	0	32
OG0000845	6	5	3	16	2	32
OG0000846	10	9	7	6	0	32
OG0000847	12	0	15	1	4	32
OG0000848	4	13	10	4	1	32
OG0000849	2	6	4	20	0	32
OG0000850	7	4	5	14	2	32
OG0000851	22	1	5	4	0	32
OG0000852	5	6	12	8	1	32
OG0000853	3	8	4	14	3	32
OG0000854	5	7	5	14	1	32
OG0000855	6	12	1	12	1	32
OG0000856	4	3	14	6	5	32
OG0000857	6	5	16	5	0	32
OG0000858	7	15	0	10	0	32
OG0000859	1	10	2	18	1	32
OG0000860	3	7	3	19	0	32
OG0000861	3	9	4	16	0	32
OG0000862	1	12	3	15	1	32
OG0000863	1	12	9	10	0	32
OG0000864	2	5	2	22	1	32
OG0000865	2	9	1	19	1	32
OG0000866	2	18	8	3	1	32
OG0000867	2	0	18	11	1	32
OG0000868	5	11	2	14	0	32
OG0000869	2	4	5	19	2	32
OG0000870	1	11	14	6	0	32
OG0000871	3	14	6	8	1	32
OG0000872	8	5	12	7	0	32
OG0000873	3	10	10	8	1	32
OG0000874	1	5	5	20	1	32
OG0000875	1	8	4	17	2	32
OG0000876	0	25	0	7	0	32
OG0000877	0	29	1	2	0	32
OG0000878	0	5	15	1	11	32
OG0000879	0	12	1	18	1	32
OG0000880	0	17	0	15	0	32
OG0000881	0	0	19	0	13	32
OG0000882	0	0	19	0	13	32
OG0000883	0	0	0	32	0	32
OG0000884	1	6	7	14	3	31
OG0000885	1	24	1	4	1	31
OG0000886	2	15	1	11	2	31
OG0000887	6	0	25	0	0	31
OG0000888	6	9	6	8	2	31
OG0000889	13	7	8	2	1	31
OG0000890	4	8	4	14	1	31
OG0000891	3	11	10	4	3	31
OG0000892	7	3	17	4	0	31
OG0000893	1	8	1	21	0	31
OG0000894	7	6	14	3	1	31
OG0000895	17	6	6	2	0	31
OG0000896	3	4	15	9	0	31
OG0000897	5	17	5	3	1	31
OG0000898	5	12	1	12	1	31
OG0000899	4	12	4	11	0	31
OG0000900	2	3	5	20	1	31
OG0000901	4	15	4	8	0	31
OG0000902	2	14	4	11	0	31
OG0000903	1	11	8	10	1	31
OG0000904	2	2	17	9	1	31
OG0000905	9	10	4	7	1	31
OG0000906	2	15	6	7	1	31
OG0000907	5	8	1	16	1	31
OG0000908	1	7	1	22	0	31
OG0000909	5	3	21	1	1	31
OG0000910	3	14	8	6	0	31
OG0000911	1	1	4	6	19	31
OG0000912	2	2	19	8	0	31
OG0000913	9	14	4	3	1	31
OG0000914	1	14	1	14	1	31
OG0000915	3	17	3	7	1	31
OG0000916	6	2	0	23	0	31
OG0000917	2	9	1	18	1	31
OG0000918	9	7	4	10	1	31
OG0000919	14	6	3	7	1	31
OG0000920	2	17	6	3	3	31
OG0000921	6	6	4	15	0	31
OG0000922	2	14	5	9	1	31
OG0000923	2	16	3	10	0	31
OG0000924	3	6	17	5	0	31
OG0000925	3	6	9	12	1	31
OG0000926	1	1	27	1	1	31
OG0000927	1	4	15	10	1	31
OG0000928	0	19	3	9	0	31
OG0000929	0	9	13	8	1	31
OG0000930	0	15	4	11	1	31
OG0000931	0	11	5	14	1	31
OG0000932	0	1	26	0	4	31
OG0000933	0	0	5	10	16	31
OG0000934	3	7	6	13	1	30
OG0000935	7	6	1	15	1	30
OG0000936	3	10	13	3	1	30
OG0000937	4	5	5	15	1	30
OG0000938	1	4	4	20	1	30
OG0000939	4	19	2	4	1	30
OG0000940	2	7	2	19	0	30
OG0000941	5	9	6	9	1	30
OG0000942	1	15	10	3	1	30
OG0000943	3	6	5	14	2	30
OG0000944	10	7	2	10	1	30
OG0000945	1	7	3	17	2	30
OG0000946	4	7	9	9	1	30
OG0000947	2	14	2	12	0	30
OG0000948	2	7	2	18	1	30
OG0000949	3	14	6	6	1	30
OG0000950	2	9	1	17	1	30
OG0000951	1	12	4	13	0	30
OG0000952	9	5	13	2	1	30
OG0000953	3	3	1	22	1	30
OG0000954	2	18	1	9	0	30
OG0000955	2	5	10	12	1	30
OG0000956	3	1	14	11	1	30
OG0000957	2	9	1	17	1	30
OG0000958	4	13	8	4	1	30
OG0000959	4	10	1	14	1	30
OG0000960	2	14	4	9	1	30
OG0000961	3	6	9	10	2	30
OG0000962	5	16	1	8	0	30
OG0000963	4	9	1	16	0	30
OG0000964	2	14	2	10	2	30
OG0000965	3	11	2	13	1	30
OG0000966	2	11	9	7	1	30
OG0000967	1	23	3	2	1	30
OG0000968	2	20	1	6	1	30
OG0000969	1	15	1	12	1	30
OG0000970	6	2	10	12	0	30
OG0000971	3	6	13	7	1	30
OG0000972	1	7	4	16	2	30
OG0000973	14	4	6	5	1	30
OG0000974	3	16	1	10	0	30
OG0000975	2	6	7	12	3	30
OG0000976	4	3	7	16	0	30
OG0000977	2	13	5	9	1	30
OG0000978	9	4	1	14	2	30
OG0000979	1	6	2	20	1	30
OG0000980	1	5	15	9	0	30
OG0000981	4	7	6	12	1	30
OG0000982	1	25	2	1	1	30
OG0000983	8	11	5	5	1	30
OG0000984	4	5	1	18	2	30
OG0000985	3	7	1	18	1	30
OG0000986	1	20	2	6	1	30
OG0000987	8	10	3	4	5	30
OG0000988	1	5	4	20	0	30
OG0000989	2	5	3	20	0	30
OG0000990	0	20	8	2	0	30
OG0000991	0	7	0	23	0	30
OG0000992	0	10	4	14	2	30
OG0000993	0	26	0	4	0	30
OG0000994	0	19	0	10	1	30
OG0000995	0	16	1	12	1	30
OG0000996	0	5	4	20	1	30
OG0000997	0	4	1	25	0	30
OG0000998	0	5	0	25	0	30
OG0000999	0	1	28	1	0	30
OG0001000	0	0	3	27	0	30
OG0001001	0	0	0	30	0	30
OG0001002	0	0	0	30	0	30
OG0001003	0	0	0	30	0	30
OG0001004	4	10	3	12	0	29
OG0001005	2	8	3	15	1	29
OG0001006	3	9	5	11	1	29
OG0001007	1	1	3	24	0	29
OG0001008	1	20	1	6	1	29
OG0001009	2	11	1	14	1	29
OG0001010	3	15	6	4	1	29
OG0001011	6	2	7	14	0	29
OG0001012	6	4	11	8	0	29
OG0001013	3	14	2	9	1	29
OG0001014	2	10	2	13	2	29
OG0001015	4	11	1	12	1	29
OG0001016	3	17	7	1	1	29
OG0001017	3	8	16	2	0	29
OG0001018	1	2	2	23	1	29
OG0001019	3	9	12	2	3	29
OG0001020	6	0	0	0	23	29
OG0001021	8	10	6	4	1	29
OG0001022	2	19	4	3	1	29
OG0001023	4	15	4	6	0	29
OG0001024	2	7	4	13	3	29
OG0001025	8	0	21	0	0	29
OG0001026	1	3	19	3	3	29
OG0001027	1	2	7	18	1	29
OG0001028	6	9	10	4	0	29
OG0001029	8	7	9	4	1	29
OG0001030	1	0	25	3	0	29
OG0001031	1	6	1	20	1	29
OG0001032	5	4	9	10	1	29
OG0001033	5	9	3	12	0	29
OG0001034	2	12	7	5	3	29
OG0001035	2	16	2	8	1	29
OG0001036	4	5	10	9	1	29
OG0001037	4	3	5	16	1	29
OG0001038	12	1	8	3	5	29
OG0001039	2	4	4	18	1	29
OG0001040	12	7	1	8	1	29
OG0001041	5	7	3	13	1	29
OG0001042	9	11	1	8	0	29
OG0001043	2	3	11	6	7	29
OG0001044	1	7	1	19	1	29
OG0001045	1	2	9	16	1	29
OG0001046	1	7	2	17	2	29
OG0001047	1	4	22	1	1	29
OG0001048	1	25	1	1	1	29
OG0001049	1	6	0	22	0	29
OG0001050	1	0	0	0	28	29
OG0001051	2	10	5	11	1	29
OG0001052	2	10	1	14	2	29
OG0001053	11	7	4	5	2	29
OG0001054	0	9	3	16	1	29
OG0001055	0	10	2	15	2	29
OG0001056	0	8	2	19	0	29
OG0001057	0	5	0	24	0	29
OG0001058	0	3	14	9	3	29
OG0001059	0	24	0	5	0	29
OG0001060	0	12	1	15	1	29
OG0001061	0	17	2	8	2	29
OG0001062	0	23	2	0	4	29
OG0001063	0	6	12	8	3	29
OG0001064	0	15	0	13	1	29
OG0001065	0	1	0	28	0	29
OG0001066	0	0	27	0	2	29
OG0001067	0	0	2	4	23	29
OG0001068	0	0	28	1	0	29
OG0001069	0	0	0	29	0	29
OG0001070	4	18	1	4	1	28
OG0001071	8	5	5	10	0	28
OG0001072	5	10	1	11	1	28
OG0001073	3	9	10	4	2	28
OG0001074	3	2	2	17	4	28
OG0001075	2	7	3	15	1	28
OG0001076	3	3	9	11	2	28
OG0001077	3	4	6	14	1	28
OG0001078	5	3	15	5	0	28
OG0001079	1	2	11	12	2	28
OG0001080	2	12	4	10	0	28
OG0001081	6	7	4	10	1	28
OG0001082	3	18	2	4	1	28
OG0001083	2	10	1	15	0	28
OG0001084	3	10	9	6	0	28
OG0001085	3	11	1	10	3	28
OG0001086	5	5	1	16	1	28
OG0001087	1	9	0	17	1	28
OG0001088	2	8	1	15	2	28
OG0001089	11	4	8	5	0	28
OG0001090	2	22	2	1	1	28
OG0001091	1	5	4	18	0	28
OG0001092	1	10	0	17	0	28
OG0001093	2	5	2	18	1	28
OG0001094	5	6	2	14	1	28
OG0001095	1	15	1	11	0	28
OG0001096	1	8	2	16	1	28
OG0001097	4	5	11	8	0	28
OG0001098	5	7	1	15	0	28
OG0001099	4	3	2	19	0	28
OG0001100	12	1	11	3	1	28
OG0001101	6	2	7	13	0	28
OG0001102	4	4	2	16	2	28
OG0001103	1	8	5	14	0	28
OG0001104	3	11	2	11	1	28
OG0001105	0	7	2	18	1	28
OG0001106	0	4	3	20	1	28
OG0001107	0	13	4	9	2	28
OG0001108	0	18	3	6	1	28
OG0001109	0	7	10	11	0	28
OG0001110	0	5	3	19	1	28
OG0001111	0	9	2	17	0	28
OG0001112	0	5	8	15	0	28
OG0001113	0	19	9	0	0	28
OG0001114	0	21	3	3	1	28
OG0001115	0	28	0	0	0	28
OG0001116	0	1	0	27	0	28
OG0001117	0	28	0	0	0	28
OG0001118	0	0	28	0	0	28
OG0001119	0	0	4	24	0	28
OG0001120	0	0	0	28	0	28
OG0001121	5	12	0	10	0	27
OG0001122	3	6	2	16	0	27
OG0001123	4	4	8	9	2	27
OG0001124	3	8	4	12	0	27
OG0001125	2	1	1	21	2	27
OG0001126	5	14	4	3	1	27
OG0001127	2	6	1	16	2	27
OG0001128	4	6	1	15	1	27
OG0001129	2	7	13	4	1	27
OG0001130	10	2	12	3	0	27
OG0001131	2	8	1	14	2	27
OG0001132	4	9	5	8	1	27
OG0001133	3	11	4	8	1	27
OG0001134	10	9	3	3	2	27
OG0001135	1	9	2	14	1	27
OG0001136	2	10	2	8	5	27
OG0001137	2	10	3	10	2	27
OG0001138	4	6	2	15	0	27
OG0001139	7	8	2	9	1	27
OG0001140	1	11	3	11	1	27
OG0001141	3	11	6	5	2	27
OG0001142	17	6	2	2	0	27
OG0001143	2	10	5	9	1	27
OG0001144	4	14	3	5	1	27
OG0001145	1	14	5	6	1	27
OG0001146	6	3	6	12	0	27
OG0001147	2	4	8	11	2	27
OG0001148	2	12	3	9	1	27
OG0001149	7	7	6	6	1	27
OG0001150	11	5	3	7	1	27
OG0001151	1	5	3	17	1	27
OG0001152	8	4	2	13	0	27
OG0001153	2	11	0	14	0	27
OG0001154	2	11	7	6	1	27
OG0001155	3	10	1	13	0	27
OG0001156	4	10	5	7	1	27
OG0001157	7	7	5	7	1	27
OG0001158	1	4	11	10	1	27
OG0001159	2	18	2	4	1	27
OG0001160	1	0	17	5	4	27
OG0001161	2	10	6	8	1	27
OG0001162	1	8	5	12	1	27
OG0001163	2	3	1	20	1	27
OG0001164	4	9	6	6	2	27
OG0001165	4	4	2	17	0	27
OG0001166	1	5	12	6	3	27
OG0001167	3	13	4	5	2	27
OG0001168	2	6	3	15	1	27
OG0001169	7	2	1	17	0	27
OG0001170	2	3	2	20	0	27
OG0001171	2	16	4	3	2	27
OG0001172	1	5	1	20	0	27
OG0001173	1	0	25	0	1	27
OG0001174	11	8	2	6	0	27
OG0001175	0	23	0	4	0	27
OG0001176	0	14	1	11	1	27
OG0001177	0	9	0	18	0	27
OG0001178	0	6	1	17	3	27
OG0001179	0	2	4	21	0	27
OG0001180	0	9	0	15	3	27
OG0001181	0	5	1	21	0	27
OG0001182	0	5	1	21	0	27
OG0001183	0	14	1	12	0	27
OG0001184	0	1	0	26	0	27
OG0001185	0	3	7	15	2	27
OG0001186	0	1	0	26	0	27
OG0001187	0	0	27	0	0	27
OG0001188	0	0	16	0	11	27
OG0001189	0	0	5	21	1	27
OG0001190	0	0	0	27	0	27
OG0001191	0	0	0	27	0	27
OG0001192	0	0	0	27	0	27
OG0001193	4	6	6	8	2	26
OG0001194	3	7	3	10	3	26
OG0001195	4	11	6	4	1	26
OG0001196	2	8	2	12	2	26
OG0001197	4	11	4	5	2	26
OG0001198	6	8	7	3	2	26
OG0001199	3	5	1	16	1	26
OG0001200	3	8	2	12	1	26
OG0001201	2	9	7	7	1	26
OG0001202	2	15	5	3	1	26
OG0001203	3	4	5	13	1	26
OG0001204	1	6	3	15	1	26
OG0001205	4	6	2	13	1	26
OG0001206	3	16	1	5	1	26
OG0001207	1	9	12	2	2	26
OG0001208	5	4	11	5	1	26
OG0001209	6	2	1	14	3	26
OG0001210	2	17	2	4	1	26
OG0001211	3	8	8	7	0	26
OG0001212	2	14	4	5	1	26
OG0001213	1	4	1	19	1	26
OG0001214	1	7	1	16	1	26
OG0001215	7	11	1	6	1	26
OG0001216	1	7	1	16	1	26
OG0001217	6	8	6	4	2	26
OG0001218	1	20	2	3	0	26
OG0001219	1	5	7	12	1	26
OG0001220	3	6	2	13	2	26
OG0001221	12	2	7	4	1	26
OG0001222	8	10	4	3	1	26
OG0001223	10	9	2	4	1	26
OG0001224	6	11	5	2	2	26
OG0001225	1	7	2	15	1	26
OG0001226	1	0	2	20	3	26
OG0001227	1	12	2	11	0	26
OG0001228	4	10	9	2	1	26
OG0001229	5	6	5	9	1	26
OG0001230	3	11	5	3	4	26
OG0001231	2	11	5	6	2	26
OG0001232	1	5	3	5	12	26
OG0001233	6	17	3	0	0	26
OG0001234	1	8	8	8	1	26
OG0001235	1	6	1	17	1	26
OG0001236	8	9	7	2	0	26
OG0001237	1	6	2	17	0	26
OG0001238	2	9	1	12	2	26
OG0001239	1	3	14	5	3	26
OG0001240	3	10	8	4	1	26
OG0001241	9	3	1	13	0	26
OG0001242	1	18	1	6	0	26
OG0001243	1	10	3	11	1	26
OG0001244	1	15	3	6	1	26
OG0001245	5	16	2	2	1	26
OG0001246	1	0	3	21	1	26
OG0001247	5	8	3	10	0	26
OG0001248	1	8	10	7	0	26
OG0001249	1	9	4	10	2	26
OG0001250	11	2	1	11	1	26
OG0001251	0	16	1	7	2	26
OG0001252	0	4	3	19	0	26
OG0001253	0	3	0	23	0	26
OG0001254	0	6	1	19	0	26
OG0001255	0	17	0	8	1	26
OG0001256	0	26	0	0	0	26
OG0001257	0	7	13	3	3	26
OG0001258	0	7	3	14	2	26
OG0001259	0	5	1	20	0	26
OG0001260	0	4	0	22	0	26
OG0001261	0	21	1	3	1	26
OG0001262	0	15	0	11	0	26
OG0001263	0	14	0	12	0	26
OG0001264	0	5	4	16	1	26
OG0001265	0	17	3	0	6	26
OG0001266	0	0	26	0	0	26
OG0001267	0	0	0	26	0	26
OG0001268	3	4	9	5	4	25
OG0001269	2	1	3	18	1	25
OG0001270	4	3	2	15	1	25
OG0001271	2	12	2	8	1	25
OG0001272	19	2	4	0	0	25
OG0001273	6	7	4	7	1	25
OG0001274	3	9	2	11	0	25
OG0001275	6	3	8	8	0	25
OG0001276	5	9	2	9	0	25
OG0001277	3	5	4	12	1	25
OG0001278	5	11	3	5	1	25
OG0001279	4	5	2	14	0	25
OG0001280	1	13	2	8	1	25
OG0001281	7	5	3	5	5	25
OG0001282	3	12	5	4	1	25
OG0001283	3	7	7	8	0	25
OG0001284	4	7	2	12	0	25
OG0001285	3	2	1	19	0	25
OG0001286	4	8	3	6	4	25
OG0001287	1	23	1	0	0	25
OG0001288	5	7	5	6	2	25
OG0001289	1	10	3	10	1	25
OG0001290	9	9	3	3	1	25
OG0001291	1	14	0	7	3	25
OG0001292	1	7	14	3	0	25
OG0001293	2	10	4	7	2	25
OG0001294	7	1	4	12	1	25
OG0001295	2	3	15	4	1	25
OG0001296	2	1	4	18	0	25
OG0001297	4	1	3	15	2	25
OG0001298	5	9	3	6	2	25
OG0001299	3	1	9	11	1	25
OG0001300	3	0	9	1	12	25
OG0001301	1	4	1	18	1	25
OG0001302	2	3	1	18	1	25
OG0001303	1	10	8	5	1	25
OG0001304	10	2	5	7	1	25
OG0001305	1	5	2	14	3	25
OG0001306	4	7	1	11	2	25
OG0001307	3	6	1	14	1	25
OG0001308	2	9	3	10	1	25
OG0001309	2	9	4	9	1	25
OG0001310	4	13	3	3	2	25
OG0001311	1	11	1	11	1	25
OG0001312	7	4	12	2	0	25
OG0001313	2	11	1	9	2	25
OG0001314	3	12	8	1	1	25
OG0001315	3	12	7	3	0	25
OG0001316	8	9	2	5	1	25
OG0001317	1	13	1	8	2	25
OG0001318	1	5	6	12	1	25
OG0001319	3	4	2	16	0	25
OG0001320	4	3	12	6	0	25
OG0001321	2	11	4	7	1	25
OG0001322	3	7	4	10	1	25
OG0001323	2	0	22	1	0	25
OG0001324	1	10	4	9	1	25
OG0001325	7	8	1	8	1	25
OG0001326	1	2	17	3	2	25
OG0001327	1	6	11	4	3	25
OG0001328	1	9	3	11	1	25
OG0001329	5	10	1	8	1	25
OG0001330	2	6	3	13	1	25
OG0001331	1	9	5	9	1	25
OG0001332	1	2	2	19	1	25
OG0001333	2	3	1	18	1	25
OG0001334	3	5	10	6	1	25
OG0001335	10	3	10	1	1	25
OG0001336	3	11	4	6	1	25
OG0001337	2	5	2	15	1	25
OG0001338	4	12	4	5	0	25
OG0001339	1	9	3	11	1	25
OG0001340	0	9	1	15	0	25
OG0001341	0	5	2	18	0	25
OG0001342	0	3	11	9	2	25
OG0001343	0	6	0	19	0	25
OG0001344	0	21	0	4	0	25
OG0001345	0	10	0	15	0	25
OG0001346	0	8	8	9	0	25
OG0001347	0	9	7	8	1	25
OG0001348	0	19	1	4	1	25
OG0001349	0	4	0	21	0	25
OG0001350	0	13	0	11	1	25
OG0001351	0	3	2	17	3	25
OG0001352	0	10	2	12	1	25
OG0001353	0	6	0	18	1	25
OG0001354	0	7	0	18	0	25
OG0001355	0	5	6	13	1	25
OG0001356	0	3	21	0	1	25
OG0001357	0	3	0	22	0	25
OG0001358	0	25	0	0	0	25
OG0001359	0	0	25	0	0	25
OG0001360	0	0	1	23	1	25
OG0001361	0	0	0	25	0	25
OG0001362	0	0	0	25	0	25
OG0001363	0	0	0	25	0	25
OG0001364	7	11	4	2	0	24
OG0001365	3	7	3	10	1	24
OG0001366	4	8	1	10	1	24
OG0001367	4	7	1	10	2	24
OG0001368	2	14	5	2	1	24
OG0001369	2	7	1	13	1	24
OG0001370	2	12	3	6	1	24
OG0001371	3	7	1	12	1	24
OG0001372	2	7	4	11	0	24
OG0001373	4	12	6	1	1	24
OG0001374	1	4	5	13	1	24
OG0001375	2	7	3	11	1	24
OG0001376	2	8	2	11	1	24
OG0001377	2	13	4	4	1	24
OG0001378	1	6	12	4	1	24
OG0001379	5	4	4	11	0	24
OG0001380	4	8	1	10	1	24
OG0001381	2	3	4	14	1	24
OG0001382	4	10	5	4	1	24
OG0001383	5	8	2	7	2	24
OG0001384	3	9	1	10	1	24
OG0001385	2	12	1	8	1	24
OG0001386	1	18	1	4	0	24
OG0001387	1	11	1	10	1	24
OG0001388	24	0	0	0	0	24
OG0001389	1	6	1	15	1	24
OG0001390	3	13	2	5	1	24
OG0001391	4	11	6	2	1	24
OG0001392	4	6	1	12	1	24
OG0001393	4	12	1	6	1	24
OG0001394	5	5	2	10	2	24
OG0001395	3	2	2	3	14	24
OG0001396	4	2	7	9	2	24
OG0001397	2	8	3	11	0	24
OG0001398	3	8	9	3	1	24
OG0001399	5	0	14	0	5	24
OG0001400	6	7	6	4	1	24
OG0001401	3	1	9	9	2	24
OG0001402	6	5	1	11	1	24
OG0001403	1	10	8	5	0	24
OG0001404	1	5	3	14	1	24
OG0001405	1	12	7	3	1	24
OG0001406	1	13	4	6	0	24
OG0001407	2	2	9	10	1	24
OG0001408	7	7	6	4	0	24
OG0001409	6	5	4	9	0	24
OG0001410	1	2	2	18	1	24
OG0001411	4	12	4	3	1	24
OG0001412	4	4	8	6	2	24
OG0001413	2	7	6	7	2	24
OG0001414	2	10	2	9	1	24
OG0001415	3	10	2	8	1	24
OG0001416	3	12	3	5	1	24
OG0001417	2	5	6	10	1	24
OG0001418	6	4	3	9	2	24
OG0001419	5	13	1	4	1	24
OG0001420	2	5	3	13	1	24
OG0001421	1	3	4	12	4	24
OG0001422	1	12	3	7	1	24
OG0001423	2	3	4	15	0	24
OG0001424	2	4	13	3	2	24
OG0001425	1	8	6	7	2	24
OG0001426	1	8	1	13	1	24
OG0001427	2	6	1	14	1	24
OG0001428	6	0	4	4	10	24
OG0001429	1	3	17	2	1	24
OG0001430	3	0	18	3	0	24
OG0001431	2	9	4	8	1	24
OG0001432	5	12	3	3	1	24
OG0001433	4	6	1	13	0	24
OG0001434	2	5	7	9	1	24
OG0001435	2	1	4	16	1	24
OG0001436	3	7	5	8	1	24
OG0001437	5	12	2	4	1	24
OG0001438	3	13	4	3	1	24
OG0001439	1	7	5	10	1	24
OG0001440	3	7	1	13	0	24
OG0001441	1	12	9	2	0	24
OG0001442	1	1	16	2	4	24
OG0001443	0	8	1	14	1	24
OG0001444	0	19	0	0	5	24
OG0001445	0	6	5	13	0	24
OG0001446	0	3	18	3	0	24
OG0001447	0	10	4	6	4	24
OG0001448	0	14	0	10	0	24
OG0001449	0	14	2	5	3	24
OG0001450	0	13	9	2	0	24
OG0001451	0	1	15	3	5	24
OG0001452	0	8	1	11	4	24
OG0001453	0	3	9	11	1	24
OG0001454	0	11	0	10	3	24
OG0001455	0	7	2	14	1	24
OG0001456	0	8	6	10	0	24
OG0001457	0	12	0	12	0	24
OG0001458	0	5	2	14	3	24
OG0001459	0	5	13	5	1	24
OG0001460	0	0	15	8	1	24
OG0001461	0	0	24	0	0	24
OG0001462	0	0	0	24	0	24
OG0001463	0	0	0	24	0	24
OG0001464	0	0	0	24	0	24
OG0001465	0	0	0	24	0	24
OG0001466	0	0	0	0	24	24
OG0001467	9	0	9	5	0	23
OG0001468	3	5	1	13	1	23
OG0001469	5	7	8	2	1	23
OG0001470	3	2	6	12	0	23
OG0001471	1	4	1	17	0	23
OG0001472	4	1	4	8	6	23
OG0001473	1	3	3	15	1	23
OG0001474	3	4	6	8	2	23
OG0001475	5	1	2	14	1	23
OG0001476	2	3	12	6	0	23
OG0001477	7	6	3	6	1	23
OG0001478	3	10	3	6	1	23
OG0001479	3	3	7	8	2	23
OG0001480	1	10	1	11	0	23
OG0001481	2	3	5	13	0	23
OG0001482	1	2	12	7	1	23
OG0001483	2	9	1	10	1	23
OG0001484	5	4	5	8	1	23
OG0001485	3	7	4	8	1	23
OG0001486	2	14	3	3	1	23
OG0001487	1	3	6	13	0	23
OG0001488	4	5	2	12	0	23
OG0001489	3	4	1	14	1	23
OG0001490	1	17	2	2	1	23
OG0001491	3	10	3	6	1	23
OG0001492	5	8	2	8	0	23
OG0001493	7	10	2	3	1	23
OG0001494	2	2	4	14	1	23
OG0001495	4	9	4	4	2	23
OG0001496	5	5	4	9	0	23
OG0001497	2	7	4	9	1	23
OG0001498	1	13	6	2	1	23
OG0001499	1	3	2	15	2	23
OG0001500	2	18	1	0	2	23
OG0001501	3	2	2	16	0	23
OG0001502	1	10	11	1	0	23
OG0001503	3	9	5	5	1	23
OG0001504	15	4	3	1	0	23
OG0001505	6	7	2	5	3	23
OG0001506	5	8	1	8	1	23
OG0001507	1	7	1	14	0	23
OG0001508	2	5	4	12	0	23
OG0001509	5	10	2	5	1	23
OG0001510	3	11	1	8	0	23
OG0001511	2	4	3	13	1	23
OG0001512	3	7	2	10	1	23
OG0001513	6	7	5	4	1	23
OG0001514	1	4	5	13	0	23
OG0001515	2	0	0	0	21	23
OG0001516	4	1	5	12	1	23
OG0001517	3	8	8	3	1	23
OG0001518	1	6	7	9	0	23
OG0001519	11	8	2	2	0	23
OG0001520	2	4	1	15	1	23
OG0001521	14	2	3	3	1	23
OG0001522	9	4	6	3	1	23
OG0001523	3	4	1	13	2	23
OG0001524	4	7	4	7	1	23
OG0001525	2	5	8	8	0	23
OG0001526	4	4	6	8	1	23
OG0001527	1	11	8	1	2	23
OG0001528	4	5	2	11	1	23
OG0001529	2	8	6	6	1	23
OG0001530	3	15	2	3	0	23
OG0001531	2	7	8	5	1	23
OG0001532	4	13	1	4	1	23
OG0001533	1	5	9	5	3	23
OG0001534	3	2	2	5	11	23
OG0001535	2	5	1	15	0	23
OG0001536	1	4	7	9	2	23
OG0001537	1	8	8	6	0	23
OG0001538	4	1	3	14	1	23
OG0001539	2	18	2	1	0	23
OG0001540	1	17	1	3	1	23
OG0001541	5	9	2	5	2	23
OG0001542	3	4	9	7	0	23
OG0001543	1	6	7	5	4	23
OG0001544	5	12	2	2	2	23
OG0001545	2	4	2	15	0	23
OG0001546	2	8	1	11	1	23
OG0001547	2	4	3	13	1	23
OG0001548	5	4	1	12	1	23
OG0001549	1	11	2	8	1	23
OG0001550	1	9	1	12	0	23
OG0001551	3	10	2	7	1	23
OG0001552	9	8	5	0	1	23
OG0001553	11	6	1	4	1	23
OG0001554	1	8	1	12	1	23
OG0001555	1	5	14	2	1	23
OG0001556	0	6	3	14	0	23
OG0001557	0	9	5	5	4	23
OG0001558	0	6	2	14	1	23
OG0001559	0	15	0	8	0	23
OG0001560	0	14	1	7	1	23
OG0001561	0	5	3	15	0	23
OG0001562	0	23	0	0	0	23
OG0001563	0	7	2	14	0	23
OG0001564	0	6	5	12	0	23
OG0001565	0	9	0	14	0	23
OG0001566	0	7	2	14	0	23
OG0001567	0	19	1	2	1	23
OG0001568	0	13	1	8	1	23
OG0001569	0	2	4	8	9	23
OG0001570	0	1	19	3	0	23
OG0001571	0	4	18	1	0	23
OG0001572	0	3	8	6	6	23
OG0001573	0	3	5	3	12	23
OG0001574	0	12	6	4	1	23
OG0001575	0	3	3	16	1	23
OG0001576	0	10	0	13	0	23
OG0001577	0	1	0	0	22	23
OG0001578	0	1	6	15	1	23
OG0001579	0	8	9	1	5	23
OG0001580	0	1	9	5	8	23
OG0001581	0	0	23	0	0	23
OG0001582	0	0	0	10	13	23
OG0001583	3	12	1	6	0	22
OG0001584	3	2	1	16	0	22
OG0001585	2	11	7	1	1	22
OG0001586	9	1	8	3	1	22
OG0001587	5	5	5	3	4	22
OG0001588	2	7	10	2	1	22
OG0001589	7	5	2	8	0	22
OG0001590	5	3	5	8	1	22
OG0001591	4	6	4	7	1	22
OG0001592	4	5	2	11	0	22
OG0001593	3	7	0	12	0	22
OG0001594	6	6	7	2	1	22
OG0001595	1	3	5	11	2	22
OG0001596	1	12	6	3	0	22
OG0001597	1	2	2	17	0	22
OG0001598	2	7	2	10	1	22
OG0001599	4	2	1	13	2	22
OG0001600	3	3	8	6	2	22
OG0001601	3	7	2	9	1	22
OG0001602	8	0	12	2	0	22
OG0001603	3	3	12	3	1	22
OG0001604	1	5	2	13	1	22
OG0001605	1	4	4	12	1	22
OG0001606	1	5	9	7	0	22
OG0001607	1	0	14	4	3	22
OG0001608	4	4	4	10	0	22
OG0001609	4	5	2	11	0	22
OG0001610	5	4	7	3	3	22
OG0001611	1	12	5	4	0	22
OG0001612	2	10	2	7	1	22
OG0001613	3	6	2	8	3	22
OG0001614	8	2	1	10	1	22
OG0001615	1	3	2	14	2	22
OG0001616	4	12	2	3	1	22
OG0001617	4	10	5	2	1	22
OG0001618	2	5	2	12	1	22
OG0001619	2	1	14	5	0	22
OG0001620	2	6	8	5	1	22
OG0001621	3	6	3	9	1	22
OG0001622	1	5	2	14	0	22
OG0001623	1	10	9	2	0	22
OG0001624	5	13	1	3	0	22
OG0001625	3	7	2	9	1	22
OG0001626	3	2	5	11	1	22
OG0001627	1	5	2	13	1	22
OG0001628	3	1	17	1	0	22
OG0001629	1	18	1	2	0	22
OG0001630	4	6	2	9	1	22
OG0001631	3	7	1	10	1	22
OG0001632	2	8	1	9	2	22
OG0001633	3	13	1	5	0	22
OG0001634	1	3	2	16	0	22
OG0001635	3	7	2	10	0	22
OG0001636	2	7	1	11	1	22
OG0001637	2	11	1	7	1	22
OG0001638	1	5	7	8	1	22
OG0001639	6	6	2	8	0	22
OG0001640	2	15	4	1	0	22
OG0001641	3	7	1	10	1	22
OG0001642	1	12	5	3	1	22
OG0001643	1	9	2	9	1	22
OG0001644	2	1	12	0	7	22
OG0001645	1	5	5	10	1	22
OG0001646	1	18	1	1	1	22
OG0001647	3	17	1	1	0	22
OG0001648	3	8	1	9	1	22
OG0001649	1	2	6	0	13	22
OG0001650	3	5	1	11	2	22
OG0001651	4	7	1	9	1	22
OG0001652	18	4	0	0	0	22
OG0001653	4	12	2	2	2	22
OG0001654	0	10	0	12	0	22
OG0001655	0	9	9	4	0	22
OG0001656	0	22	0	0	0	22
OG0001657	0	8	0	14	0	22
OG0001658	0	12	0	10	0	22
OG0001659	0	5	1	15	1	22
OG0001660	0	8	5	6	3	22
OG0001661	0	10	4	6	2	22
OG0001662	0	10	8	4	0	22
OG0001663	0	13	1	8	0	22
OG0001664	0	1	2	19	0	22
OG0001665	0	14	1	5	2	22
OG0001666	0	15	1	6	0	22
OG0001667	0	8	0	13	1	22
OG0001668	0	3	3	14	2	22
OG0001669	0	3	6	6	7	22
OG0001670	0	8	2	12	0	22
OG0001671	0	6	7	2	7	22
OG0001672	0	7	0	15	0	22
OG0001673	0	13	1	7	1	22
OG0001674	0	1	8	12	1	22
OG0001675	0	17	0	5	0	22
OG0001676	0	0	16	0	6	22
OG0001677	0	0	21	0	1	22
OG0001678	0	0	22	0	0	22
OG0001679	0	0	20	1	1	22
OG0001680	0	0	2	18	2	22
OG0001681	0	0	0	0	22	22
OG0001682	1	0	17	3	0	21
OG0001683	1	7	2	11	0	21
OG0001684	1	8	3	5	4	21
OG0001685	4	1	5	10	1	21
OG0001686	2	1	7	9	2	21
OG0001687	8	2	6	3	2	21
OG0001688	2	8	0	10	1	21
OG0001689	4	7	5	4	1	21
OG0001690	7	5	6	3	0	21
OG0001691	6	2	4	6	3	21
OG0001692	7	6	5	3	0	21
OG0001693	5	6	2	7	1	21
OG0001694	6	3	3	8	1	21
OG0001695	2	6	1	11	1	21
OG0001696	3	1	5	12	0	21
OG0001697	2	6	1	12	0	21
OG0001698	2	7	3	9	0	21
OG0001699	7	8	2	3	1	21
OG0001700	2	0	2	16	1	21
OG0001701	2	5	5	8	1	21
OG0001702	2	6	2	10	1	21
OG0001703	14	1	4	2	0	21
OG0001704	1	2	11	7	0	21
OG0001705	1	1	1	17	1	21
OG0001706	2	6	1	12	0	21
OG0001707	2	3	1	14	1	21
OG0001708	3	4	1	12	1	21
OG0001709	1	2	4	13	1	21
OG0001710	1	2	4	6	8	21
OG0001711	3	14	2	0	2	21
OG0001712	4	3	4	6	4	21
OG0001713	5	0	3	0	13	21
OG0001714	4	3	2	11	1	21
OG0001715	1	16	2	1	1	21
OG0001716	1	5	2	13	0	21
OG0001717	1	1	1	17	1	21
OG0001718	1	4	3	9	4	21
OG0001719	1	11	3	5	1	21
OG0001720	2	5	5	9	0	21
OG0001721	1	7	7	5	1	21
OG0001722	2	9	4	5	1	21
OG0001723	1	3	5	11	1	21
OG0001724	3	4	11	2	1	21
OG0001725	6	5	7	3	0	21
OG0001726	1	11	5	2	2	21
OG0001727	2	4	1	13	1	21
OG0001728	2	6	1	11	1	21
OG0001729	1	0	12	7	1	21
OG0001730	2	1	9	8	1	21
OG0001731	4	5	1	10	1	21
OG0001732	2	4	14	1	0	21
OG0001733	1	8	3	2	7	21
OG0001734	3	8	5	4	1	21
OG0001735	4	5	2	9	1	21
OG0001736	3	13	2	2	1	21
OG0001737	3	5	5	5	3	21
OG0001738	2	6	6	7	0	21
OG0001739	2	6	4	9	0	21
OG0001740	1	2	13	3	2	21
OG0001741	1	2	3	14	1	21
OG0001742	5	3	5	7	1	21
OG0001743	4	5	3	8	1	21
OG0001744	3	2	4	10	2	21
OG0001745	7	9	1	3	1	21
OG0001746	1	8	6	6	0	21
OG0001747	8	0	2	2	9	21
OG0001748	1	7	2	11	0	21
OG0001749	7	2	3	8	1	21
OG0001750	2	2	3	13	1	21
OG0001751	2	0	3	10	6	21
OG0001752	1	0	3	9	8	21
OG0001753	8	5	1	7	0	21
OG0001754	5	9	1	5	1	21
OG0001755	1	8	6	5	1	21
OG0001756	3	16	1	0	1	21
OG0001757	2	10	2	6	1	21
OG0001758	3	8	5	3	2	21
OG0001759	1	6	4	10	0	21
OG0001760	0	9	2	9	1	21
OG0001761	0	8	6	6	1	21
OG0001762	0	11	9	1	0	21
OG0001763	0	5	1	15	0	21
OG0001764	0	9	1	10	1	21
OG0001765	0	4	0	15	2	21
OG0001766	0	6	8	6	1	21
OG0001767	0	4	0	17	0	21
OG0001768	0	16	0	5	0	21
OG0001769	0	4	4	13	0	21
OG0001770	0	4	2	15	0	21
OG0001771	0	3	0	7	11	21
OG0001772	0	9	0	12	0	21
OG0001773	0	11	4	6	0	21
OG0001774	0	11	0	10	0	21
OG0001775	0	8	4	6	3	21
OG0001776	0	2	2	17	0	21
OG0001777	0	4	0	17	0	21
OG0001778	0	5	13	2	1	21
OG0001779	0	12	0	9	0	21
OG0001780	0	19	0	1	1	21
OG0001781	0	6	6	9	0	21
OG0001782	0	8	0	13	0	21
OG0001783	0	17	1	2	1	21
OG0001784	0	6	2	13	0	21
OG0001785	0	11	0	10	0	21
OG0001786	0	7	3	11	0	21
OG0001787	0	20	0	1	0	21
OG0001788	0	21	0	0	0	21
OG0001789	0	13	0	8	0	21
OG0001790	0	1	9	11	0	21
OG0001791	0	17	1	3	0	21
OG0001792	0	1	1	19	0	21
OG0001793	0	1	0	20	0	21
OG0001794	0	0	20	0	1	21
OG0001795	0	0	8	13	0	21
OG0001796	0	0	19	0	2	21
OG0001797	0	0	19	2	0	21
OG0001798	0	0	21	0	0	21
OG0001799	0	0	2	19	0	21
OG0001800	0	0	2	18	1	21
OG0001801	0	0	0	21	0	21
OG0001802	0	0	0	21	0	21
OG0001803	0	0	0	21	0	21
OG0001804	0	0	0	21	0	21
OG0001805	0	0	0	21	0	21
OG0001806	0	0	0	0	21	21
OG0001807	1	4	1	13	1	20
OG0001808	4	3	3	10	0	20
OG0001809	17	0	0	0	3	20
OG0001810	2	6	3	7	2	20
OG0001811	1	6	1	10	2	20
OG0001812	9	1	1	7	2	20
OG0001813	2	1	11	2	4	20
OG0001814	3	11	2	4	0	20
OG0001815	2	6	4	7	1	20
OG0001816	11	4	2	3	0	20
OG0001817	1	4	1	13	1	20
OG0001818	1	1	0	18	0	20
OG0001819	5	1	1	12	1	20
OG0001820	2	8	2	7	1	20
OG0001821	6	3	2	8	1	20
OG0001822	7	8	3	2	0	20
OG0001823	4	13	2	0	1	20
OG0001824	3	5	1	10	1	20
OG0001825	1	11	2	6	0	20
OG0001826	4	6	1	8	1	20
OG0001827	2	8	4	6	0	20
OG0001828	2	12	2	4	0	20
OG0001829	2	13	2	3	0	20
OG0001830	3	3	11	3	0	20
OG0001831	2	7	5	4	2	20
OG0001832	1	12	1	5	1	20
OG0001833	2	3	2	13	0	20
OG0001834	7	0	12	0	1	20
OG0001835	3	7	4	5	1	20
OG0001836	2	4	1	12	1	20
OG0001837	1	2	2	14	1	20
OG0001838	1	5	1	12	1	20
OG0001839	2	2	3	13	0	20
OG0001840	1	3	5	10	1	20
OG0001841	2	7	1	9	1	20
OG0001842	8	2	2	6	2	20
OG0001843	4	4	1	11	0	20
OG0001844	1	8	2	7	2	20
OG0001845	7	2	2	8	1	20
OG0001846	3	6	2	9	0	20
OG0001847	1	14	1	3	1	20
OG0001848	1	8	1	9	1	20
OG0001849	2	4	2	12	0	20
OG0001850	2	3	3	11	1	20
OG0001851	3	5	7	4	1	20
OG0001852	1	15	1	1	2	20
OG0001853	3	9	3	5	0	20
OG0001854	2	1	1	14	2	20
OG0001855	1	15	1	2	1	20
OG0001856	4	10	1	4	1	20
OG0001857	8	3	5	4	0	20
OG0001858	2	3	5	10	0	20
OG0001859	2	5	3	9	1	20
OG0001860	1	6	5	7	1	20
OG0001861	9	4	5	2	0	20
OG0001862	3	3	2	12	0	20
OG0001863	4	2	5	8	1	20
OG0001864	10	4	5	1	0	20
OG0001865	2	5	1	10	2	20
OG0001866	5	4	10	0	1	20
OG0001867	1	1	3	15	0	20
OG0001868	1	11	2	6	0	20
OG0001869	1	2	10	6	1	20
OG0001870	3	2	10	4	1	20
OG0001871	2	11	3	3	1	20
OG0001872	2	2	8	6	2	20
OG0001873	1	3	1	15	0	20
OG0001874	3	8	1	8	0	20
OG0001875	4	12	1	3	0	20
OG0001876	5	6	3	6	0	20
OG0001877	5	8	2	4	1	20
OG0001878	2	7	8	1	2	20
OG0001879	7	3	4	6	0	20
OG0001880	5	10	1	4	0	20
OG0001881	3	8	2	6	1	20
OG0001882	9	3	3	5	0	20
OG0001883	6	4	5	4	1	20
OG0001884	1	8	1	10	0	20
OG0001885	2	7	1	9	1	20
OG0001886	2	9	8	1	0	20
OG0001887	5	0	3	12	0	20
OG0001888	3	8	4	4	1	20
OG0001889	3	4	1	11	1	20
OG0001890	3	3	1	12	1	20
OG0001891	2	10	5	3	0	20
OG0001892	2	2	2	13	1	20
OG0001893	1	6	4	6	3	20
OG0001894	2	10	5	1	2	20
OG0001895	1	4	7	4	4	20
OG0001896	1	12	2	5	0	20
OG0001897	3	5	3	8	1	20
OG0001898	1	7	2	9	1	20
OG0001899	1	6	5	7	1	20
OG0001900	4	5	6	4	1	20
OG0001901	1	2	4	12	1	20
OG0001902	1	5	1	12	1	20
OG0001903	1	10	2	7	0	20
OG0001904	2	4	3	10	1	20
OG0001905	1	5	3	5	6	20
OG0001906	2	3	1	13	1	20
OG0001907	3	9	7	1	0	20
OG0001908	9	7	1	1	2	20
OG0001909	2	3	1	13	1	20
OG0001910	2	5	6	7	0	20
OG0001911	6	3	6	4	1	20
OG0001912	1	10	4	3	2	20
OG0001913	3	8	2	6	1	20
OG0001914	1	7	1	11	0	20
OG0001915	2	5	1	11	1	20
OG0001916	4	16	0	0	0	20
OG0001917	1	7	1	11	0	20
OG0001918	1	10	1	6	2	20
OG0001919	0	1	12	3	4	20
OG0001920	0	3	3	13	1	20
OG0001921	0	7	10	2	1	20
OG0001922	0	12	1	5	2	20
OG0001923	0	20	0	0	0	20
OG0001924	0	20	0	0	0	20
OG0001925	0	3	0	17	0	20
OG0001926	0	11	1	7	1	20
OG0001927	0	4	1	15	0	20
OG0001928	0	6	7	6	1	20
OG0001929	0	3	2	15	0	20
OG0001930	0	4	0	16	0	20
OG0001931	0	17	1	2	0	20
OG0001932	0	20	0	0	0	20
OG0001933	0	4	15	1	0	20
OG0001934	0	13	0	7	0	20
OG0001935	0	10	6	4	0	20
OG0001936	0	18	2	0	0	20
OG0001937	0	4	7	8	1	20
OG0001938	0	6	1	12	1	20
OG0001939	0	5	1	14	0	20
OG0001940	0	19	0	1	0	20
OG0001941	0	2	1	12	5	20
OG0001942	0	20	0	0	0	20
OG0001943	0	6	4	9	1	20
OG0001944	0	4	1	14	1	20
OG0001945	0	12	0	6	2	20
OG0001946	0	12	0	8	0	20
OG0001947	0	13	3	4	0	20
OG0001948	0	18	0	2	0	20
OG0001949	0	0	15	0	5	20
OG0001950	0	0	20	0	0	20
OG0001951	0	0	20	0	0	20
OG0001952	0	0	12	1	7	20
OG0001953	0	0	16	0	4	20
OG0001954	0	0	5	4	11	20
OG0001955	0	0	2	18	0	20
OG0001956	0	0	3	17	0	20
OG0001957	0	0	10	9	1	20
OG0001958	0	0	0	20	0	20
OG0001959	0	0	0	20	0	20
OG0001960	0	0	0	20	0	20
OG0001961	19	0	0	0	0	19
OG0001962	5	2	1	10	1	19
OG0001963	2	1	11	4	1	19
OG0001964	4	9	1	4	1	19
OG0001965	5	4	7	2	1	19
OG0001966	4	5	6	3	1	19
OG0001967	16	2	1	0	0	19
OG0001968	7	4	6	2	0	19
OG0001969	4	5	2	8	0	19
OG0001970	2	6	4	6	1	19
OG0001971	2	3	2	11	1	19
OG0001972	1	5	2	10	1	19
OG0001973	4	8	6	1	0	19
OG0001974	3	3	3	9	1	19
OG0001975	4	6	1	7	1	19
OG0001976	6	1	7	5	0	19
OG0001977	7	9	2	1	0	19
OG0001978	1	12	2	3	1	19
OG0001979	13	1	3	1	1	19
OG0001980	4	3	6	4	2	19
OG0001981	2	5	4	4	4	19
OG0001982	4	5	3	6	1	19
OG0001983	1	13	1	3	1	19
OG0001984	11	1	2	4	1	19
OG0001985	6	2	2	8	1	19
OG0001986	1	5	2	9	2	19
OG0001987	1	11	4	2	1	19
OG0001988	2	5	2	10	0	19
OG0001989	1	4	2	11	1	19
OG0001990	1	15	2	1	0	19
OG0001991	3	13	2	1	0	19
OG0001992	2	6	4	6	1	19
OG0001993	2	9	1	6	1	19
OG0001994	2	11	3	2	1	19
OG0001995	1	8	1	8	1	19
OG0001996	3	6	4	5	1	19
OG0001997	1	3	2	13	0	19
OG0001998	1	9	5	2	2	19
OG0001999	4	7	2	5	1	19
OG0002000	3	1	2	12	1	19
OG0002001	7	4	1	5	2	19
OG0002002	6	7	2	4	0	19
OG0002003	2	12	1	4	0	19
OG0002004	4	5	6	4	0	19
OG0002005	2	5	3	7	2	19
OG0002006	6	9	0	4	0	19
OG0002007	5	3	2	8	1	19
OG0002008	2	3	6	4	4	19
OG0002009	1	8	5	4	1	19
OG0002010	1	3	5	5	5	19
OG0002011	4	11	1	2	1	19
OG0002012	6	2	9	1	1	19
OG0002013	2	8	5	3	1	19
OG0002014	1	2	2	13	1	19
OG0002015	6	4	1	7	1	19
OG0002016	2	7	4	6	0	19
OG0002017	4	4	2	8	1	19
OG0002018	1	3	2	12	1	19
OG0002019	3	3	5	5	3	19
OG0002020	3	2	3	10	1	19
OG0002021	3	6	2	8	0	19
OG0002022	1	11	3	3	1	19
OG0002023	1	9	3	5	1	19
OG0002024	2	11	3	2	1	19
OG0002025	2	3	2	11	1	19
OG0002026	2	1	5	11	0	19
OG0002027	2	9	4	4	0	19
OG0002028	4	4	3	7	1	19
OG0002029	3	10	4	2	0	19
OG0002030	2	7	1	7	2	19
OG0002031	1	1	8	8	1	19
OG0002032	1	0	15	3	0	19
OG0002033	2	10	0	7	0	19
OG0002034	2	9	1	7	0	19
OG0002035	1	10	1	4	3	19
OG0002036	2	11	2	4	0	19
OG0002037	1	0	12	2	4	19
OG0002038	2	3	10	3	1	19
OG0002039	7	9	1	2	0	19
OG0002040	2	6	5	6	0	19
OG0002041	2	1	2	13	1	19
OG0002042	2	6	1	9	1	19
OG0002043	1	12	3	2	1	19
OG0002044	4	5	6	4	0	19
OG0002045	5	7	2	4	1	19
OG0002046	13	3	2	1	0	19
OG0002047	1	3	7	7	1	19
OG0002048	1	5	1	10	2	19
OG0002049	2	7	3	5	2	19
OG0002050	2	2	1	13	1	19
OG0002051	2	7	2	8	0	19
OG0002052	3	5	1	9	1	19
OG0002053	4	3	2	9	1	19
OG0002054	1	3	4	11	0	19
OG0002055	1	12	1	4	1	19
OG0002056	2	7	1	9	0	19
OG0002057	3	5	3	8	0	19
OG0002058	2	1	13	2	1	19
OG0002059	1	2	8	1	7	19
OG0002060	2	4	6	6	1	19
OG0002061	1	3	2	12	1	19
OG0002062	1	7	3	7	1	19
OG0002063	3	2	0	14	0	19
OG0002064	2	11	1	2	3	19
OG0002065	1	9	2	7	0	19
OG0002066	2	3	1	12	1	19
OG0002067	1	6	6	5	1	19
OG0002068	1	5	3	9	1	19
OG0002069	2	0	13	4	0	19
OG0002070	2	9	1	6	1	19
OG0002071	1	5	3	9	1	19
OG0002072	1	6	3	8	1	19
OG0002073	1	0	2	15	1	19
OG0002074	1	9	2	6	1	19
OG0002075	2	6	3	7	1	19
OG0002076	1	1	2	14	1	19
OG0002077	2	2	5	9	1	19
OG0002078	7	4	1	7	0	19
OG0002079	3	3	6	7	0	19
OG0002080	0	9	4	6	0	19
OG0002081	0	9	3	7	0	19
OG0002082	0	9	1	9	0	19
OG0002083	0	10	1	8	0	19
OG0002084	0	6	1	12	0	19
OG0002085	0	12	0	7	0	19
OG0002086	0	6	13	0	0	19
OG0002087	0	8	7	4	0	19
OG0002088	0	17	0	2	0	19
OG0002089	0	19	0	0	0	19
OG0002090	0	2	10	7	0	19
OG0002091	0	5	7	7	0	19
OG0002092	0	2	4	13	0	19
OG0002093	0	13	0	6	0	19
OG0002094	0	1	3	15	0	19
OG0002095	0	13	2	4	0	19
OG0002096	0	4	1	13	1	19
OG0002097	0	2	7	9	1	19
OG0002098	0	9	3	7	0	19
OG0002099	0	6	6	6	1	19
OG0002100	0	11	1	6	1	19
OG0002101	0	2	5	11	1	19
OG0002102	0	12	0	6	1	19
OG0002103	0	4	12	3	0	19
OG0002104	0	6	1	12	0	19
OG0002105	0	7	1	4	7	19
OG0002106	0	1	0	18	0	19
OG0002107	0	1	1	16	1	19
OG0002108	0	17	1	1	0	19
OG0002109	0	11	0	7	1	19
OG0002110	0	2	10	6	1	19
OG0002111	0	11	1	6	1	19
OG0002112	0	1	5	13	0	19
OG0002113	0	13	1	3	2	19
OG0002114	0	1	9	6	3	19
OG0002115	0	17	0	2	0	19
OG0002116	0	1	5	8	5	19
OG0002117	0	0	11	4	4	19
OG0002118	0	0	12	2	5	19
OG0002119	0	0	1	18	0	19
OG0002120	0	0	19	0	0	19
OG0002121	0	0	5	13	1	19
OG0002122	0	0	10	7	2	19
OG0002123	0	0	0	19	0	19
OG0002124	0	0	0	19	0	19
OG0002125	0	0	0	19	0	19
OG0002126	1	0	15	2	0	18
OG0002127	2	4	3	5	4	18
OG0002128	1	8	1	8	0	18
OG0002129	1	3	1	12	1	18
OG0002130	5	1	4	7	1	18
OG0002131	3	0	8	7	0	18
OG0002132	4	8	1	5	0	18
OG0002133	4	3	1	7	3	18
OG0002134	5	7	2	4	0	18
OG0002135	4	5	4	3	2	18
OG0002136	4	4	7	3	0	18
OG0002137	1	8	0	9	0	18
OG0002138	2	3	1	11	1	18
OG0002139	9	3	1	3	2	18
OG0002140	4	2	6	2	4	18
OG0002141	1	1	4	12	0	18
OG0002142	5	1	4	8	0	18
OG0002143	2	1	3	11	1	18
OG0002144	1	6	1	9	1	18
OG0002145	2	5	2	6	3	18
OG0002146	15	0	0	3	0	18
OG0002147	4	3	5	3	3	18
OG0002148	1	7	1	8	1	18
OG0002149	18	0	0	0	0	18
OG0002150	1	4	4	8	1	18
OG0002151	1	12	1	3	1	18
OG0002152	2	5	2	8	1	18
OG0002153	2	4	5	6	1	18
OG0002154	10	1	1	6	0	18
OG0002155	2	7	4	4	1	18
OG0002156	1	3	4	10	0	18
OG0002157	1	9	1	6	1	18
OG0002158	4	6	3	3	2	18
OG0002159	1	0	7	4	6	18
OG0002160	2	5	5	5	1	18
OG0002161	16	0	2	0	0	18
OG0002162	5	3	5	4	1	18
OG0002163	3	4	2	9	0	18
OG0002164	2	4	1	10	1	18
OG0002165	2	2	2	11	1	18
OG0002166	2	5	2	9	0	18
OG0002167	3	5	3	6	1	18
OG0002168	8	5	0	5	0	18
OG0002169	5	6	2	3	2	18
OG0002170	2	8	2	4	2	18
OG0002171	3	12	1	2	0	18
OG0002172	3	4	4	5	2	18
OG0002173	4	7	2	4	1	18
OG0002174	2	5	1	9	1	18
OG0002175	2	4	9	3	0	18
OG0002176	1	4	1	10	2	18
OG0002177	1	4	3	9	1	18
OG0002178	1	14	1	1	1	18
OG0002179	4	5	2	6	1	18
OG0002180	5	6	4	3	0	18
OG0002181	4	2	1	9	2	18
OG0002182	4	1	9	2	2	18
OG0002183	1	3	2	12	0	18
OG0002184	3	6	2	6	1	18
OG0002185	2	5	3	8	0	18
OG0002186	2	5	2	8	1	18
OG0002187	5	6	2	1	4	18
OG0002188	4	3	4	7	0	18
OG0002189	2	4	2	9	1	18
OG0002190	2	6	5	4	1	18
OG0002191	5	7	0	6	0	18
OG0002192	1	6	1	9	1	18
OG0002193	2	2	4	9	1	18
OG0002194	2	6	3	2	5	18
OG0002195	3	6	5	3	1	18
OG0002196	11	0	6	0	1	18
OG0002197	4	4	5	5	0	18
OG0002198	1	10	3	4	0	18
OG0002199	4	1	3	9	1	18
OG0002200	2	3	6	7	0	18
OG0002201	1	12	2	2	1	18
OG0002202	2	5	4	7	0	18
OG0002203	3	3	2	10	0	18
OG0002204	11	1	2	4	0	18
OG0002205	1	6	1	9	1	18
OG0002206	4	3	4	5	2	18
OG0002207	2	4	2	8	2	18
OG0002208	3	1	12	1	1	18
OG0002209	2	11	2	3	0	18
OG0002210	2	7	3	6	0	18
OG0002211	4	3	2	7	2	18
OG0002212	10	4	2	1	1	18
OG0002213	2	2	3	10	1	18
OG0002214	3	8	0	7	0	18
OG0002215	8	4	3	2	1	18
OG0002216	4	8	1	1	4	18
OG0002217	4	4	1	9	0	18
OG0002218	3	6	2	6	1	18
OG0002219	1	8	5	3	1	18
OG0002220	2	1	3	11	1	18
OG0002221	4	2	1	10	1	18
OG0002222	8	1	9	0	0	18
OG0002223	3	6	4	4	1	18
OG0002224	2	5	4	6	1	18
OG0002225	1	12	2	2	1	18
OG0002226	1	7	1	8	1	18
OG0002227	2	0	2	13	1	18
OG0002228	2	4	3	8	1	18
OG0002229	3	6	1	8	0	18
OG0002230	2	8	2	6	0	18
OG0002231	4	4	5	4	1	18
OG0002232	4	3	1	10	0	18
OG0002233	1	4	3	9	1	18
OG0002234	2	7	4	4	1	18
OG0002235	1	4	2	10	1	18
OG0002236	3	7	4	4	0	18
OG0002237	3	11	2	1	1	18
OG0002238	3	4	2	8	1	18
OG0002239	18	0	0	0	0	18
OG0002240	3	1	8	5	1	18
OG0002241	2	10	4	2	0	18
OG0002242	1	3	1	12	1	18
OG0002243	1	0	5	10	2	18
OG0002244	2	2	7	5	2	18
OG0002245	1	10	2	4	1	18
OG0002246	1	9	4	3	1	18
OG0002247	1	0	0	17	0	18
OG0002248	1	2	1	13	1	18
OG0002249	4	9	1	3	1	18
OG0002250	2	2	9	5	0	18
OG0002251	4	10	1	2	1	18
OG0002252	5	1	2	9	1	18
OG0002253	1	2	9	3	3	18
OG0002254	5	3	2	8	0	18
OG0002255	6	4	1	6	1	18
OG0002256	1	5	1	10	1	18
OG0002257	1	0	3	2	12	18
OG0002258	1	2	4	11	0	18
OG0002259	0	3	0	8	7	18
OG0002260	0	3	0	13	2	18
OG0002261	0	4	0	14	0	18
OG0002262	0	7	3	7	1	18
OG0002263	0	11	0	7	0	18
OG0002264	0	10	3	3	2	18
OG0002265	0	15	0	3	0	18
OG0002266	0	2	0	16	0	18
OG0002267	0	15	1	2	0	18
OG0002268	0	7	1	9	1	18
OG0002269	0	6	2	7	3	18
OG0002270	0	6	9	2	1	18
OG0002271	0	8	1	8	1	18
OG0002272	0	4	1	12	1	18
OG0002273	0	9	5	2	2	18
OG0002274	0	3	0	15	0	18
OG0002275	0	3	10	5	0	18
OG0002276	0	2	0	16	0	18
OG0002277	0	5	0	13	0	18
OG0002278	0	5	2	10	1	18
OG0002279	0	4	12	1	1	18
OG0002280	0	8	0	10	0	18
OG0002281	0	1	3	14	0	18
OG0002282	0	5	4	7	2	18
OG0002283	0	10	1	6	1	18
OG0002284	0	5	0	12	1	18
OG0002285	0	16	0	2	0	18
OG0002286	0	6	8	3	1	18
OG0002287	0	4	0	14	0	18
OG0002288	0	15	2	1	0	18
OG0002289	0	16	1	0	1	18
OG0002290	0	18	0	0	0	18
OG0002291	0	7	0	11	0	18
OG0002292	0	3	1	8	6	18
OG0002293	0	7	5	6	0	18
OG0002294	0	5	11	1	1	18
OG0002295	0	2	2	14	0	18
OG0002296	0	6	1	10	1	18
OG0002297	0	3	0	15	0	18
OG0002298	0	0	16	1	1	18
OG0002299	0	0	18	0	0	18
OG0002300	0	0	2	16	0	18
OG0002301	0	0	1	17	0	18
OG0002302	0	0	18	0	0	18
OG0002303	0	0	7	7	4	18
OG0002304	0	0	18	0	0	18
OG0002305	0	0	3	0	15	18
OG0002306	0	0	6	9	3	18
OG0002307	0	0	1	17	0	18
OG0002308	0	0	1	17	0	18
OG0002309	0	0	0	18	0	18
OG0002310	0	0	0	18	0	18
OG0002311	0	0	0	18	0	18
OG0002312	0	0	0	18	0	18
OG0002313	0	0	0	18	0	18
OG0002314	0	0	0	18	0	18
OG0002315	2	4	2	9	0	17
OG0002316	1	2	3	10	1	17
OG0002317	4	6	4	1	2	17
OG0002318	7	1	1	7	1	17
OG0002319	2	4	1	9	1	17
OG0002320	2	4	4	6	1	17
OG0002321	1	3	1	12	0	17
OG0002322	11	0	3	0	3	17
OG0002323	1	3	2	11	0	17
OG0002324	2	9	2	4	0	17
OG0002325	3	3	2	8	1	17
OG0002326	2	3	5	6	1	17
OG0002327	8	2	3	2	2	17
OG0002328	1	9	3	2	2	17
OG0002329	1	1	11	3	1	17
OG0002330	1	1	3	11	1	17
OG0002331	2	5	1	8	1	17
OG0002332	3	7	3	4	0	17
OG0002333	5	6	1	5	0	17
OG0002334	2	3	3	7	2	17
OG0002335	3	3	2	7	2	17
OG0002336	1	3	1	11	1	17
OG0002337	1	0	4	12	0	17
OG0002338	1	12	2	1	1	17
OG0002339	2	2	2	10	1	17
OG0002340	7	5	1	3	1	17
OG0002341	3	5	1	7	1	17
OG0002342	2	3	1	10	1	17
OG0002343	2	5	1	8	1	17
OG0002344	2	7	1	6	1	17
OG0002345	1	4	1	10	1	17
OG0002346	4	2	2	9	0	17
OG0002347	2	4	9	1	1	17
OG0002348	1	2	3	10	1	17
OG0002349	16	0	0	0	1	17
OG0002350	7	4	2	2	2	17
OG0002351	1	3	1	10	2	17
OG0002352	1	8	2	5	1	17
OG0002353	2	8	2	5	0	17
OG0002354	1	10	2	3	1	17
OG0002355	1	11	1	3	1	17
OG0002356	3	2	6	5	1	17
OG0002357	2	2	8	3	2	17
OG0002358	2	6	4	3	2	17
OG0002359	13	0	4	0	0	17
OG0002360	2	3	5	6	1	17
OG0002361	2	4	2	8	1	17
OG0002362	2	5	4	4	2	17
OG0002363	4	4	2	5	2	17
OG0002364	1	7	2	6	1	17
OG0002365	1	7	0	8	1	17
OG0002366	4	3	2	7	1	17
OG0002367	2	2	1	12	0	17
OG0002368	7	2	5	2	1	17
OG0002369	3	0	0	8	6	17
OG0002370	2	9	2	3	1	17
OG0002371	3	6	1	6	1	17
OG0002372	6	3	5	2	1	17
OG0002373	3	3	3	7	1	17
OG0002374	2	7	1	6	1	17
OG0002375	1	1	13	1	1	17
OG0002376	1	5	1	8	2	17
OG0002377	4	5	4	3	1	17
OG0002378	1	10	3	2	1	17
OG0002379	11	0	6	0	0	17
OG0002380	5	3	3	5	1	17
OG0002381	1	1	4	10	1	17
OG0002382	3	10	1	2	1	17
OG0002383	1	4	2	9	1	17
OG0002384	2	6	2	6	1	17
OG0002385	6	6	2	2	1	17
OG0002386	1	3	2	10	1	17
OG0002387	2	2	3	9	1	17
OG0002388	1	3	2	11	0	17
OG0002389	2	2	2	9	2	17
OG0002390	2	1	1	12	1	17
OG0002391	1	7	2	7	0	17
OG0002392	1	3	6	6	1	17
OG0002393	7	1	6	2	1	17
OG0002394	1	8	3	4	1	17
OG0002395	1	10	4	1	1	17
OG0002396	3	8	1	4	1	17
OG0002397	17	0	0	0	0	17
OG0002398	1	8	2	5	1	17
OG0002399	17	0	0	0	0	17
OG0002400	1	7	1	6	2	17
OG0002401	2	3	2	9	1	17
OG0002402	6	4	1	5	1	17
OG0002403	4	5	2	6	0	17
OG0002404	3	0	4	9	1	17
OG0002405	1	4	3	8	1	17
OG0002406	3	2	8	4	0	17
OG0002407	1	1	2	12	1	17
OG0002408	2	6	1	7	1	17
OG0002409	1	8	1	7	0	17
OG0002410	2	6	7	1	1	17
OG0002411	1	1	1	13	1	17
OG0002412	1	7	1	7	1	17
OG0002413	4	7	3	3	0	17
OG0002414	17	0	0	0	0	17
OG0002415	1	3	9	3	1	17
OG0002416	1	1	1	13	1	17
OG0002417	3	4	2	8	0	17
OG0002418	1	1	1	9	5	17
OG0002419	5	3	0	8	1	17
OG0002420	6	4	2	4	1	17
OG0002421	1	13	1	1	1	17
OG0002422	1	8	3	4	1	17
OG0002423	1	6	2	7	1	17
OG0002424	1	2	11	2	1	17
OG0002425	1	4	1	10	1	17
OG0002426	3	6	4	2	2	17
OG0002427	2	6	1	6	2	17
OG0002428	4	1	8	4	0	17
OG0002429	1	3	1	12	0	17
OG0002430	2	6	2	5	2	17
OG0002431	1	6	4	4	2	17
OG0002432	3	12	1	1	0	17
OG0002433	2	2	1	8	4	17
OG0002434	1	7	3	5	1	17
OG0002435	2	4	5	5	1	17
OG0002436	2	4	3	6	2	17
OG0002437	5	7	2	2	1	17
OG0002438	1	8	1	7	0	17
OG0002439	1	4	2	9	1	17
OG0002440	2	0	3	11	1	17
OG0002441	1	6	3	6	1	17
OG0002442	6	5	4	1	1	17
OG0002443	4	4	1	8	0	17
OG0002444	8	0	3	5	1	17
OG0002445	2	10	4	1	0	17
OG0002446	1	9	4	2	1	17
OG0002447	1	3	5	7	1	17
OG0002448	3	4	2	8	0	17
OG0002449	5	6	2	3	1	17
OG0002450	9	3	2	2	1	17
OG0002451	3	5	1	6	2	17
OG0002452	5	3	1	7	1	17
OG0002453	7	2	4	4	0	17
OG0002454	2	6	3	3	3	17
OG0002455	5	2	5	3	2	17
OG0002456	2	3	1	11	0	17
OG0002457	1	5	5	5	1	17
OG0002458	2	8	2	4	1	17
OG0002459	3	3	0	10	1	17
OG0002460	1	14	1	1	0	17
OG0002461	1	3	3	9	1	17
OG0002462	6	2	9	0	0	17
OG0002463	3	6	3	5	0	17
OG0002464	0	6	6	4	1	17
OG0002465	0	1	5	10	1	17
OG0002466	0	6	3	7	1	17
OG0002467	0	10	1	5	1	17
OG0002468	0	13	0	4	0	17
OG0002469	0	12	1	4	0	17
OG0002470	0	1	2	14	0	17
OG0002471	0	2	6	8	1	17
OG0002472	0	8	2	6	1	17
OG0002473	0	6	6	5	0	17
OG0002474	0	1	1	15	0	17
OG0002475	0	5	4	8	0	17
OG0002476	0	14	1	1	1	17
OG0002477	0	6	0	11	0	17
OG0002478	0	3	1	13	0	17
OG0002479	0	9	4	4	0	17
OG0002480	0	1	9	1	6	17
OG0002481	0	16	1	0	0	17
OG0002482	0	8	3	4	2	17
OG0002483	0	5	4	8	0	17
OG0002484	0	11	1	5	0	17
OG0002485	0	3	3	10	1	17
OG0002486	0	8	5	2	2	17
OG0002487	0	6	6	5	0	17
OG0002488	0	1	0	16	0	17
OG0002489	0	6	3	7	1	17
OG0002490	0	17	0	0	0	17
OG0002491	0	11	4	2	0	17
OG0002492	0	3	8	5	1	17
OG0002493	0	3	10	0	4	17
OG0002494	0	11	0	5	1	17
OG0002495	0	10	4	3	0	17
OG0002496	0	1	3	11	2	17
OG0002497	0	3	6	8	0	17
OG0002498	0	17	0	0	0	17
OG0002499	0	10	0	7	0	17
OG0002500	0	9	2	6	0	17
OG0002501	0	7	4	5	1	17
OG0002502	0	10	1	5	1	17
OG0002503	0	2	7	5	3	17
OG0002504	0	1	6	9	1	17
OG0002505	0	15	0	2	0	17
OG0002506	0	14	1	1	1	17
OG0002507	0	10	3	4	0	17
OG0002508	0	2	1	14	0	17
OG0002509	0	14	2	1	0	17
OG0002510	0	1	0	16	0	17
OG0002511	0	2	10	4	1	17
OG0002512	0	0	5	12	0	17
OG0002513	0	0	12	1	4	17
OG0002514	0	0	1	16	0	17
OG0002515	0	0	3	4	10	17
OG0002516	0	0	14	3	0	17
OG0002517	0	0	14	1	2	17
OG0002518	0	0	1	16	0	17
OG0002519	0	0	8	8	1	17
OG0002520	0	0	5	8	4	17
OG0002521	0	0	1	16	0	17
OG0002522	0	0	3	14	0	17
OG0002523	0	0	3	14	0	17
OG0002524	0	0	0	17	0	17
OG0002525	0	0	0	17	0	17
OG0002526	0	0	0	17	0	17
OG0002527	0	0	0	16	1	17
OG0002528	0	0	0	17	0	17
OG0002529	0	0	0	16	1	17
OG0002530	3	5	1	5	2	16
OG0002531	1	2	8	4	1	16
OG0002532	1	2	2	10	1	16
OG0002533	1	2	1	12	0	16
OG0002534	5	4	2	4	1	16
OG0002535	3	3	3	4	3	16
OG0002536	3	1	1	9	2	16
OG0002537	1	11	1	2	1	16
OG0002538	2	1	1	11	1	16
OG0002539	2	4	1	8	1	16
OG0002540	5	4	1	5	1	16
OG0002541	1	10	1	3	1	16
OG0002542	1	4	6	3	2	16
OG0002543	5	2	2	6	1	16
OG0002544	4	2	2	8	0	16
OG0002545	3	7	3	2	1	16
OG0002546	3	3	4	5	1	16
OG0002547	3	6	3	2	2	16
OG0002548	5	5	2	4	0	16
OG0002549	2	5	5	3	1	16
OG0002550	7	5	1	2	1	16
OG0002551	1	5	2	7	1	16
OG0002552	3	2	1	8	2	16
OG0002553	3	2	7	2	2	16
OG0002554	1	5	5	2	3	16
OG0002555	3	2	1	8	2	16
OG0002556	1	3	3	7	2	16
OG0002557	2	4	1	8	1	16
OG0002558	1	6	6	2	1	16
OG0002559	1	1	12	2	0	16
OG0002560	1	4	0	11	0	16
OG0002561	3	7	2	3	1	16
OG0002562	15	0	1	0	0	16
OG0002563	3	6	2	4	1	16
OG0002564	5	2	1	8	0	16
OG0002565	11	1	0	2	2	16
OG0002566	1	7	4	3	1	16
OG0002567	1	5	4	4	2	16
OG0002568	3	2	7	3	1	16
OG0002569	2	3	2	8	1	16
OG0002570	4	3	1	7	1	16
OG0002571	2	4	2	7	1	16
OG0002572	2	7	2	4	1	16
OG0002573	1	4	1	9	1	16
OG0002574	5	7	1	2	1	16
OG0002575	12	0	4	0	0	16
OG0002576	3	7	4	1	1	16
OG0002577	3	1	7	3	2	16
OG0002578	2	2	1	10	1	16
OG0002579	2	0	6	7	1	16
OG0002580	1	11	1	3	0	16
OG0002581	2	6	1	6	1	16
OG0002582	2	3	1	9	1	16
OG0002583	3	3	6	4	0	16
OG0002584	15	0	1	0	0	16
OG0002585	1	5	4	5	1	16
OG0002586	2	2	1	11	0	16
OG0002587	2	3	2	9	0	16
OG0002588	2	8	1	4	1	16
OG0002589	3	6	2	5	0	16
OG0002590	2	1	1	11	1	16
OG0002591	4	5	2	4	1	16
OG0002592	2	5	2	6	1	16
OG0002593	1	6	2	5	2	16
OG0002594	1	2	4	8	1	16
OG0002595	3	0	9	3	1	16
OG0002596	2	3	1	9	1	16
OG0002597	3	5	2	5	1	16
OG0002598	1	3	1	10	1	16
OG0002599	5	3	2	5	1	16
OG0002600	1	10	1	4	0	16
OG0002601	3	1	1	10	1	16
OG0002602	1	12	1	1	1	16
OG0002603	2	12	1	1	0	16
OG0002604	2	12	2	0	0	16
OG0002605	2	6	2	5	1	16
OG0002606	3	1	1	11	0	16
OG0002607	1	1	1	12	1	16
OG0002608	1	8	1	5	1	16
OG0002609	5	7	1	2	1	16
OG0002610	4	4	1	6	1	16
OG0002611	2	4	7	3	0	16
OG0002612	2	5	6	3	0	16
OG0002613	7	2	1	5	1	16
OG0002614	1	5	1	9	0	16
OG0002615	1	6	2	6	1	16
OG0002616	2	2	3	8	1	16
OG0002617	2	3	2	9	0	16
OG0002618	1	8	2	4	1	16
OG0002619	5	4	3	4	0	16
OG0002620	2	5	2	6	1	16
OG0002621	2	6	4	3	1	16
OG0002622	2	2	3	9	0	16
OG0002623	1	9	0	5	1	16
OG0002624	1	3	5	7	0	16
OG0002625	7	7	1	0	1	16
OG0002626	1	1	2	10	2	16
OG0002627	4	1	3	8	0	16
OG0002628	2	3	4	6	1	16
OG0002629	3	5	5	2	1	16
OG0002630	1	3	3	7	2	16
OG0002631	2	6	3	5	0	16
OG0002632	1	6	2	6	1	16
OG0002633	1	6	2	6	1	16
OG0002634	1	5	6	2	2	16
OG0002635	3	2	7	3	1	16
OG0002636	1	2	3	9	1	16
OG0002637	3	4	1	7	1	16
OG0002638	3	2	4	7	0	16
OG0002639	1	1	2	11	1	16
OG0002640	5	6	3	1	1	16
OG0002641	1	2	3	9	1	16
OG0002642	16	0	0	0	0	16
OG0002643	5	4	2	5	0	16
OG0002644	2	0	2	12	0	16
OG0002645	3	3	3	6	1	16
OG0002646	1	5	1	8	1	16
OG0002647	3	2	2	7	2	16
OG0002648	1	10	1	4	0	16
OG0002649	4	2	9	1	0	16
OG0002650	1	4	8	2	1	16
OG0002651	2	2	1	8	3	16
OG0002652	1	4	1	9	1	16
OG0002653	2	1	1	12	0	16
OG0002654	2	3	2	8	1	16
OG0002655	2	2	2	9	1	16
OG0002656	2	1	3	9	1	16
OG0002657	1	3	4	7	1	16
OG0002658	1	7	2	5	1	16
OG0002659	2	8	1	4	1	16
OG0002660	1	2	2	10	1	16
OG0002661	3	5	2	6	0	16
OG0002662	2	6	7	1	0	16
OG0002663	3	1	4	7	1	16
OG0002664	1	2	1	11	1	16
OG0002665	3	8	1	3	1	16
OG0002666	2	7	3	3	1	16
OG0002667	4	1	5	0	6	16
OG0002668	2	3	1	9	1	16
OG0002669	4	3	4	4	1	16
OG0002670	1	10	1	3	1	16
OG0002671	1	6	4	3	2	16
OG0002672	1	4	1	9	1	16
OG0002673	2	1	11	1	1	16
OG0002674	1	14	1	0	0	16
OG0002675	3	1	1	10	1	16
OG0002676	8	2	2	4	0	16
OG0002677	3	0	4	0	9	16
OG0002678	2	6	2	5	1	16
OG0002679	2	2	3	8	1	16
OG0002680	1	1	4	8	2	16
OG0002681	3	4	4	3	2	16
OG0002682	1	1	2	11	1	16
OG0002683	3	8	3	2	0	16
OG0002684	1	6	2	7	0	16
OG0002685	10	2	1	2	1	16
OG0002686	1	6	2	6	1	16
OG0002687	1	2	1	11	1	16
OG0002688	1	7	0	8	0	16
OG0002689	1	9	5	1	0	16
OG0002690	1	9	1	5	0	16
OG0002691	5	1	3	6	1	16
OG0002692	1	1	2	11	1	16
OG0002693	1	3	3	9	0	16
OG0002694	1	7	2	5	1	16
OG0002695	1	0	7	7	1	16
OG0002696	14	0	1	0	1	16
OG0002697	7	2	1	6	0	16
OG0002698	2	6	4	3	1	16
OG0002699	1	4	7	3	1	16
OG0002700	2	5	1	8	0	16
OG0002701	0	5	0	11	0	16
OG0002702	0	12	2	2	0	16
OG0002703	0	3	0	12	1	16
OG0002704	0	6	2	7	1	16
OG0002705	0	5	5	6	0	16
OG0002706	0	16	0	0	0	16
OG0002707	0	10	4	1	1	16
OG0002708	0	5	7	3	1	16
OG0002709	0	1	0	15	0	16
OG0002710	0	4	1	11	0	16
OG0002711	0	7	2	4	3	16
OG0002712	0	9	0	7	0	16
OG0002713	0	9	2	3	2	16
OG0002714	0	1	15	0	0	16
OG0002715	0	10	1	5	0	16
OG0002716	0	13	0	3	0	16
OG0002717	0	13	1	1	1	16
OG0002718	0	1	12	3	0	16
OG0002719	0	4	2	8	2	16
OG0002720	0	7	0	9	0	16
OG0002721	0	5	10	0	1	16
OG0002722	0	9	1	4	2	16
OG0002723	0	3	8	5	0	16
OG0002724	0	11	0	1	4	16
OG0002725	0	3	0	12	1	16
OG0002726	0	6	0	10	0	16
OG0002727	0	6	6	4	0	16
OG0002728	0	9	0	7	0	16
OG0002729	0	12	0	4	0	16
OG0002730	0	8	2	6	0	16
OG0002731	0	14	1	0	1	16
OG0002732	0	10	1	2	3	16
OG0002733	0	15	1	0	0	16
OG0002734	0	5	6	3	2	16
OG0002735	0	4	1	9	2	16
OG0002736	0	12	1	2	1	16
OG0002737	0	1	1	14	0	16
OG0002738	0	16	0	0	0	16
OG0002739	0	2	6	5	3	16
OG0002740	0	1	3	11	1	16
OG0002741	0	1	13	2	0	16
OG0002742	0	0	16	0	0	16
OG0002743	0	0	9	5	2	16
OG0002744	0	0	15	0	1	16
OG0002745	0	0	15	1	0	16
OG0002746	0	0	16	0	0	16
OG0002747	0	0	1	14	1	16
OG0002748	0	0	0	16	0	16
OG0002749	0	0	0	15	1	16
OG0002750	0	0	0	16	0	16
OG0002751	0	0	0	16	0	16
OG0002752	0	0	0	0	16	16
OG0002753	0	0	0	0	16	16
OG0002754	0	0	0	0	16	16
OG0002755	1	2	1	11	0	15
OG0002756	3	1	6	5	0	15
OG0002757	2	4	1	7	1	15
OG0002758	1	11	0	2	1	15
OG0002759	1	3	3	7	1	15
OG0002760	1	4	1	9	0	15
OG0002761	1	4	2	8	0	15
OG0002762	2	5	4	2	2	15
OG0002763	3	2	1	6	3	15
OG0002764	5	1	8	1	0	15
OG0002765	3	2	1	8	1	15
OG0002766	4	1	5	4	1	15
OG0002767	1	6	1	6	1	15
OG0002768	3	5	2	5	0	15
OG0002769	11	2	0	2	0	15
OG0002770	1	0	1	13	0	15
OG0002771	3	1	2	9	0	15
OG0002772	3	5	3	4	0	15
OG0002773	3	0	5	6	1	15
OG0002774	2	0	9	4	0	15
OG0002775	3	2	4	6	0	15
OG0002776	3	2	8	1	1	15
OG0002777	1	4	4	5	1	15
OG0002778	1	5	2	6	1	15
OG0002779	2	4	4	4	1	15
OG0002780	1	3	1	9	1	15
OG0002781	1	3	3	7	1	15
OG0002782	3	4	2	5	1	15
OG0002783	4	4	4	3	0	15
OG0002784	1	3	2	9	0	15
OG0002785	5	5	1	4	0	15
OG0002786	1	9	1	4	0	15
OG0002787	1	3	2	9	0	15
OG0002788	1	6	6	2	0	15
OG0002789	1	5	1	8	0	15
OG0002790	3	3	3	6	0	15
OG0002791	2	9	1	2	1	15
OG0002792	1	5	1	7	1	15
OG0002793	1	3	1	10	0	15
OG0002794	5	1	1	7	1	15
OG0002795	1	3	3	6	2	15
OG0002796	1	4	1	8	1	15
OG0002797	2	2	3	7	1	15
OG0002798	1	10	1	2	1	15
OG0002799	2	2	5	4	2	15
OG0002800	5	4	1	4	1	15
OG0002801	1	3	1	10	0	15
OG0002802	3	7	3	1	1	15
OG0002803	2	7	1	4	1	15
OG0002804	1	4	2	7	1	15
OG0002805	2	1	1	8	3	15
OG0002806	2	2	3	7	1	15
OG0002807	2	2	2	8	1	15
OG0002808	5	4	1	3	2	15
OG0002809	1	3	1	9	1	15
OG0002810	4	1	1	6	3	15
OG0002811	2	4	3	4	2	15
OG0002812	1	8	1	3	2	15
OG0002813	2	4	4	3	2	15
OG0002814	3	3	1	6	2	15
OG0002815	5	1	2	6	1	15
OG0002816	6	6	2	1	0	15
OG0002817	5	1	1	7	1	15
OG0002818	1	3	1	9	1	15
OG0002819	7	6	1	0	1	15
OG0002820	2	5	3	4	1	15
OG0002821	4	3	1	7	0	15
OG0002822	7	2	1	4	1	15
OG0002823	3	4	1	6	1	15
OG0002824	2	2	6	4	1	15
OG0002825	1	4	4	5	1	15
OG0002826	3	8	2	2	0	15
OG0002827	1	5	1	7	1	15
OG0002828	5	4	2	2	2	15
OG0002829	3	1	3	7	1	15
OG0002830	2	2	2	8	1	15
OG0002831	4	5	2	4	0	15
OG0002832	1	4	1	9	0	15
OG0002833	6	0	8	0	1	15
OG0002834	1	6	3	4	1	15
OG0002835	1	3	4	6	1	15
OG0002836	2	7	4	1	1	15
OG0002837	2	6	2	4	1	15
OG0002838	2	6	2	4	1	15
OG0002839	3	2	4	6	0	15
OG0002840	3	8	1	1	2	15
OG0002841	1	7	2	4	1	15
OG0002842	1	6	1	7	0	15
OG0002843	1	3	2	8	1	15
OG0002844	2	7	4	2	0	15
OG0002845	1	1	2	10	1	15
OG0002846	3	2	2	8	0	15
OG0002847	1	3	1	8	2	15
OG0002848	2	1	2	9	1	15
OG0002849	2	2	4	5	2	15
OG0002850	2	4	4	4	1	15
OG0002851	1	6	1	7	0	15
OG0002852	3	3	3	5	1	15
OG0002853	1	4	2	7	1	15
OG0002854	1	6	4	4	0	15
OG0002855	1	2	1	10	1	15
OG0002856	4	6	2	2	1	15
OG0002857	2	8	1	4	0	15
OG0002858	3	8	1	2	1	15
OG0002859	1	2	2	9	1	15
OG0002860	1	1	12	1	0	15
OG0002861	2	5	4	3	1	15
OG0002862	3	7	3	1	1	15
OG0002863	1	4	3	6	1	15
OG0002864	1	2	3	8	1	15
OG0002865	1	5	1	6	2	15
OG0002866	2	6	2	4	1	15
OG0002867	1	1	9	3	1	15
OG0002868	1	1	3	2	8	15
OG0002869	3	1	1	9	1	15
OG0002870	3	0	0	11	1	15
OG0002871	3	2	5	5	0	15
OG0002872	1	8	2	2	2	15
OG0002873	2	7	1	4	1	15
OG0002874	2	2	1	9	1	15
OG0002875	1	2	1	11	0	15
OG0002876	1	5	0	9	0	15
OG0002877	2	3	3	6	1	15
OG0002878	1	4	2	7	1	15
OG0002879	2	10	1	1	1	15
OG0002880	1	6	2	6	0	15
OG0002881	1	6	1	6	1	15
OG0002882	3	2	1	8	1	15
OG0002883	1	1	2	10	1	15
OG0002884	1	2	8	4	0	15
OG0002885	6	0	9	0	0	15
OG0002886	4	3	5	2	1	15
OG0002887	3	3	1	7	1	15
OG0002888	3	1	5	5	1	15
OG0002889	2	6	3	2	2	15
OG0002890	7	2	1	4	1	15
OG0002891	2	2	1	7	3	15
OG0002892	5	1	3	2	4	15
OG0002893	2	6	2	5	0	15
OG0002894	5	3	1	4	2	15
OG0002895	2	1	1	10	1	15
OG0002896	1	6	1	7	0	15
OG0002897	1	9	1	4	0	15
OG0002898	1	8	2	1	3	15
OG0002899	3	5	4	2	1	15
OG0002900	1	4	2	6	2	15
OG0002901	2	6	1	5	1	15
OG0002902	4	2	2	6	1	15
OG0002903	1	5	1	7	1	15
OG0002904	5	2	1	5	2	15
OG0002905	1	10	2	2	0	15
OG0002906	3	2	7	2	1	15
OG0002907	2	1	0	11	1	15
OG0002908	5	5	1	3	1	15
OG0002909	1	1	5	7	1	15
OG0002910	1	2	1	11	0	15
OG0002911	2	3	1	9	0	15
OG0002912	1	9	1	4	0	15
OG0002913	4	0	2	0	9	15
OG0002914	2	1	5	4	3	15
OG0002915	8	0	7	0	0	15
OG0002916	1	5	6	2	1	15
OG0002917	1	7	1	4	2	15
OG0002918	2	5	2	5	1	15
OG0002919	1	5	2	4	3	15
OG0002920	7	0	4	2	2	15
OG0002921	4	2	5	2	2	15
OG0002922	1	5	1	7	1	15
OG0002923	1	3	3	5	3	15
OG0002924	2	6	2	4	1	15
OG0002925	4	7	1	2	1	15
OG0002926	8	3	1	3	0	15
OG0002927	7	2	1	4	1	15
OG0002928	2	1	2	10	0	15
OG0002929	7	3	2	2	1	15
OG0002930	3	2	6	4	0	15
OG0002931	3	6	3	2	1	15
OG0002932	1	1	1	11	1	15
OG0002933	2	1	4	7	1	15
OG0002934	1	8	2	3	1	15
OG0002935	2	4	3	5	1	15
OG0002936	2	7	3	2	1	15
OG0002937	0	6	1	8	0	15
OG0002938	0	5	3	6	1	15
OG0002939	0	7	2	6	0	15
OG0002940	0	2	8	2	3	15
OG0002941	0	6	4	5	0	15
OG0002942	0	8	2	5	0	15
OG0002943	0	9	0	5	1	15
OG0002944	0	3	7	3	2	15
OG0002945	0	12	0	3	0	15
OG0002946	0	4	0	10	1	15
OG0002947	0	5	2	8	0	15
OG0002948	0	4	6	5	0	15
OG0002949	0	6	3	6	0	15
OG0002950	0	8	4	2	1	15
OG0002951	0	2	5	6	2	15
OG0002952	0	4	0	5	6	15
OG0002953	0	2	8	5	0	15
OG0002954	0	9	1	4	1	15
OG0002955	0	6	2	7	0	15
OG0002956	0	7	2	6	0	15
OG0002957	0	5	4	6	0	15
OG0002958	0	5	4	5	1	15
OG0002959	0	3	6	6	0	15
OG0002960	0	7	1	7	0	15
OG0002961	0	4	6	5	0	15
OG0002962	0	4	3	8	0	15
OG0002963	0	7	2	6	0	15
OG0002964	0	6	0	9	0	15
OG0002965	0	4	11	0	0	15
OG0002966	0	9	2	4	0	15
OG0002967	0	6	1	6	2	15
OG0002968	0	9	1	3	2	15
OG0002969	0	8	0	7	0	15
OG0002970	0	12	0	3	0	15
OG0002971	0	10	0	5	0	15
OG0002972	0	4	2	8	1	15
OG0002973	0	15	0	0	0	15
OG0002974	0	1	1	13	0	15
OG0002975	0	5	4	6	0	15
OG0002976	0	2	8	3	2	15
OG0002977	0	5	2	7	1	15
OG0002978	0	5	1	9	0	15
OG0002979	0	4	0	11	0	15
OG0002980	0	4	9	2	0	15
OG0002981	0	14	0	1	0	15
OG0002982	0	5	0	9	1	15
OG0002983	0	1	0	14	0	15
OG0002984	0	3	8	3	1	15
OG0002985	0	1	0	14	0	15
OG0002986	0	8	4	2	1	15
OG0002987	0	1	8	2	4	15
OG0002988	0	1	10	3	1	15
OG0002989	0	1	0	14	0	15
OG0002990	0	1	3	10	1	15
OG0002991	0	0	13	0	2	15
OG0002992	0	0	10	0	5	15
OG0002993	0	0	10	0	5	15
OG0002994	0	0	5	7	3	15
OG0002995	0	0	15	0	0	15
OG0002996	0	0	5	7	3	15
OG0002997	0	0	0	12	3	15
OG0002998	0	0	0	15	0	15
OG0002999	0	0	0	15	0	15
OG0003000	0	0	0	0	15	15
OG0003001	1	6	2	4	1	14
OG0003002	4	5	3	1	1	14
OG0003003	14	0	0	0	0	14
OG0003004	1	8	1	3	1	14
OG0003005	1	4	1	8	0	14
OG0003006	4	3	1	5	1	14
OG0003007	3	1	1	8	1	14
OG0003008	1	4	1	7	1	14
OG0003009	3	2	1	7	1	14
OG0003010	1	5	4	3	1	14
OG0003011	2	2	3	6	1	14
OG0003012	5	4	1	4	0	14
OG0003013	3	2	2	6	1	14
OG0003014	1	2	3	7	1	14
OG0003015	2	5	6	1	0	14
OG0003016	1	6	4	2	1	14
OG0003017	2	9	1	2	0	14
OG0003018	2	1	4	5	2	14
OG0003019	1	5	1	6	1	14
OG0003020	2	4	2	5	1	14
OG0003021	3	1	4	5	1	14
OG0003022	1	7	1	4	1	14
OG0003023	3	6	1	4	0	14
OG0003024	2	3	2	6	1	14
OG0003025	4	2	2	3	3	14
OG0003026	5	6	1	1	1	14
OG0003027	2	2	3	5	2	14
OG0003028	2	8	2	1	1	14
OG0003029	4	4	3	2	1	14
OG0003030	4	1	6	2	1	14
OG0003031	3	2	3	5	1	14
OG0003032	1	2	5	6	0	14
OG0003033	7	1	2	4	0	14
OG0003034	5	1	1	5	2	14
OG0003035	1	8	3	2	0	14
OG0003036	3	2	2	6	1	14
OG0003037	2	2	5	4	1	14
OG0003038	1	1	1	11	0	14
OG0003039	3	9	1	1	0	14
OG0003040	1	3	2	7	1	14
OG0003041	2	3	2	6	1	14
OG0003042	2	1	2	7	2	14
OG0003043	3	1	3	6	1	14
OG0003044	1	4	4	4	1	14
OG0003045	4	1	4	4	1	14
OG0003046	1	3	3	6	1	14
OG0003047	2	1	5	6	0	14
OG0003048	2	1	4	6	1	14
OG0003049	4	3	2	4	1	14
OG0003050	3	2	8	0	1	14
OG0003051	2	4	1	6	1	14
OG0003052	1	1	7	5	0	14
OG0003053	2	9	1	1	1	14
OG0003054	1	2	3	7	1	14
OG0003055	1	6	1	2	4	14
OG0003056	2	1	2	8	1	14
OG0003057	1	7	1	5	0	14
OG0003058	1	3	1	8	1	14
OG0003059	2	7	1	3	1	14
OG0003060	2	3	3	5	1	14
OG0003061	4	3	2	4	1	14
OG0003062	4	0	4	5	1	14
OG0003063	3	5	1	4	1	14
OG0003064	2	9	1	1	1	14
OG0003065	4	6	1	2	1	14
OG0003066	1	3	2	7	1	14
OG0003067	1	4	1	7	1	14
OG0003068	4	2	2	5	1	14
OG0003069	2	0	1	5	6	14
OG0003070	2	8	1	2	1	14
OG0003071	2	4	2	6	0	14
OG0003072	3	2	1	7	1	14
OG0003073	1	2	1	8	2	14
OG0003074	1	5	2	6	0	14
OG0003075	2	1	7	3	1	14
OG0003076	2	1	2	8	1	14
OG0003077	1	4	1	7	1	14
OG0003078	1	5	2	6	0	14
OG0003079	1	6	2	4	1	14
OG0003080	4	2	1	6	1	14
OG0003081	3	6	1	3	1	14
OG0003082	1	8	2	3	0	14
OG0003083	1	3	3	7	0	14
OG0003084	3	4	2	3	2	14
OG0003085	1	7	1	4	1	14
OG0003086	1	10	1	1	1	14
OG0003087	1	4	4	3	2	14
OG0003088	2	1	3	7	1	14
OG0003089	1	6	2	5	0	14
OG0003090	2	2	2	7	1	14
OG0003091	3	2	4	3	2	14
OG0003092	1	6	4	2	1	14
OG0003093	2	5	1	5	1	14
OG0003094	3	3	2	6	0	14
OG0003095	1	3	5	4	1	14
OG0003096	2	6	3	2	1	14
OG0003097	2	3	2	7	0	14
OG0003098	9	0	1	4	0	14
OG0003099	4	3	3	2	2	14
OG0003100	3	4	2	3	2	14
OG0003101	2	6	1	4	1	14
OG0003102	2	4	2	5	1	14
OG0003103	1	2	1	4	6	14
OG0003104	1	2	5	6	0	14
OG0003105	1	9	1	1	2	14
OG0003106	14	0	0	0	0	14
OG0003107	2	3	2	6	1	14
OG0003108	1	5	1	7	0	14
OG0003109	2	2	3	6	1	14
OG0003110	9	1	2	1	1	14
OG0003111	2	2	2	6	2	14
OG0003112	4	3	2	4	1	14
OG0003113	2	5	4	3	0	14
OG0003114	2	3	2	7	0	14
OG0003115	1	3	1	7	2	14
OG0003116	1	2	1	9	1	14
OG0003117	3	1	2	7	1	14
OG0003118	4	4	2	1	3	14
OG0003119	1	4	1	7	1	14
OG0003120	1	2	4	5	2	14
OG0003121	2	4	1	7	0	14
OG0003122	2	2	1	8	1	14
OG0003123	4	1	1	8	0	14
OG0003124	1	1	1	10	1	14
OG0003125	1	12	1	0	0	14
OG0003126	1	2	2	8	1	14
OG0003127	5	3	4	2	0	14
OG0003128	1	3	3	6	1	14
OG0003129	1	3	3	6	1	14
OG0003130	1	4	5	4	0	14
OG0003131	1	5	3	4	1	14
OG0003132	1	2	1	9	1	14
OG0003133	1	1	2	10	0	14
OG0003134	2	1	2	9	0	14
OG0003135	2	2	5	4	1	14
OG0003136	2	7	1	4	0	14
OG0003137	1	1	2	10	0	14
OG0003138	1	4	2	6	1	14
OG0003139	3	5	2	3	1	14
OG0003140	2	2	2	7	1	14
OG0003141	1	2	2	8	1	14
OG0003142	1	2	3	6	2	14
OG0003143	2	3	2	7	0	14
OG0003144	2	1	2	8	1	14
OG0003145	1	5	0	7	1	14
OG0003146	2	1	4	5	2	14
OG0003147	1	5	4	3	1	14
OG0003148	1	6	1	5	1	14
OG0003149	2	5	0	7	0	14
OG0003150	1	4	1	7	1	14
OG0003151	1	5	2	6	0	14
OG0003152	1	2	10	1	0	14
OG0003153	1	5	0	7	1	14
OG0003154	1	6	1	5	1	14
OG0003155	1	1	1	11	0	14
OG0003156	1	0	2	10	1	14
OG0003157	1	1	0	12	0	14
OG0003158	1	6	3	3	1	14
OG0003159	2	7	2	1	2	14
OG0003160	9	0	1	1	3	14
OG0003161	2	2	3	7	0	14
OG0003162	1	1	1	10	1	14
OG0003163	1	2	3	7	1	14
OG0003164	2	7	2	3	0	14
OG0003165	2	3	4	4	1	14
OG0003166	3	5	2	4	0	14
OG0003167	1	4	2	6	1	14
OG0003168	1	2	2	9	0	14
OG0003169	1	2	3	7	1	14
OG0003170	2	4	1	5	2	14
OG0003171	1	6	3	2	2	14
OG0003172	1	2	6	4	1	14
OG0003173	1	1	2	9	1	14
OG0003174	4	5	1	3	1	14
OG0003175	5	4	2	3	0	14
OG0003176	1	8	1	3	1	14
OG0003177	4	2	1	5	2	14
OG0003178	2	4	2	6	0	14
OG0003179	4	1	1	7	1	14
OG0003180	3	3	1	6	1	14
OG0003181	1	2	2	9	0	14
OG0003182	2	6	1	4	1	14
OG0003183	2	4	4	4	0	14
OG0003184	1	4	3	6	0	14
OG0003185	3	2	1	7	1	14
OG0003186	5	2	1	4	2	14
OG0003187	1	7	2	4	0	14
OG0003188	1	4	3	5	1	14
OG0003189	6	2	2	3	1	14
OG0003190	4	5	0	5	0	14
OG0003191	1	2	2	8	1	14
OG0003192	2	7	1	2	2	14
OG0003193	2	2	2	7	1	14
OG0003194	1	2	0	10	1	14
OG0003195	2	3	8	1	0	14
OG0003196	5	4	1	2	2	14
OG0003197	1	2	1	9	1	14
OG0003198	2	5	4	2	1	14
OG0003199	4	1	4	4	1	14
OG0003200	9	0	3	2	0	14
OG0003201	1	0	9	3	1	14
OG0003202	4	3	4	3	0	14
OG0003203	7	0	7	0	0	14
OG0003204	4	4	1	5	0	14
OG0003205	1	6	2	4	1	14
OG0003206	2	0	9	3	0	14
OG0003207	2	3	5	3	1	14
OG0003208	1	4	1	7	1	14
OG0003209	1	4	2	6	1	14
OG0003210	1	2	4	6	1	14
OG0003211	4	3	4	2	1	14
OG0003212	1	1	4	7	1	14
OG0003213	1	4	4	3	2	14
OG0003214	1	6	2	3	2	14
OG0003215	2	1	4	3	4	14
OG0003216	1	11	1	1	0	14
OG0003217	6	0	1	6	1	14
OG0003218	6	1	3	4	0	14
OG0003219	1	7	2	3	1	14
OG0003220	1	4	2	6	1	14
OG0003221	1	5	1	6	1	14
OG0003222	6	8	0	0	0	14
OG0003223	1	4	3	5	1	14
OG0003224	2	0	2	10	0	14
OG0003225	8	3	1	1	1	14
OG0003226	2	8	2	1	1	14
OG0003227	7	0	7	0	0	14
OG0003228	1	4	1	8	0	14
OG0003229	5	3	3	2	1	14
OG0003230	1	10	1	1	1	14
OG0003231	4	1	5	3	1	14
OG0003232	2	7	1	3	1	14
OG0003233	3	5	2	3	1	14
OG0003234	3	5	1	4	1	14
OG0003235	2	6	2	1	3	14
OG0003236	1	9	1	3	0	14
OG0003237	1	3	1	8	1	14
OG0003238	5	1	4	2	2	14
OG0003239	3	2	5	3	1	14
OG0003240	3	4	1	5	1	14
OG0003241	7	3	3	1	0	14
OG0003242	2	8	2	1	1	14
OG0003243	0	4	2	8	0	14
OG0003244	0	2	4	8	0	14
OG0003245	0	3	2	9	0	14
OG0003246	0	7	1	6	0	14
OG0003247	0	3	0	11	0	14
OG0003248	0	2	1	10	1	14
OG0003249	0	5	2	4	3	14
OG0003250	0	1	8	4	1	14
OG0003251	0	10	4	0	0	14
OG0003252	0	3	4	7	0	14
OG0003253	0	11	3	0	0	14
OG0003254	0	1	2	8	3	14
OG0003255	0	5	2	6	1	14
OG0003256	0	6	2	6	0	14
OG0003257	0	1	1	12	0	14
OG0003258	0	2	0	11	1	14
OG0003259	0	7	0	7	0	14
OG0003260	0	6	1	5	2	14
OG0003261	0	2	2	10	0	14
OG0003262	0	3	1	9	1	14
OG0003263	0	6	1	2	5	14
OG0003264	0	5	5	4	0	14
OG0003265	0	5	2	7	0	14
OG0003266	0	2	1	11	0	14
OG0003267	0	5	4	4	1	14
OG0003268	0	6	3	4	1	14
OG0003269	0	3	0	11	0	14
OG0003270	0	3	3	8	0	14
OG0003271	0	4	7	2	1	14
OG0003272	0	2	8	3	1	14
OG0003273	0	5	1	7	1	14
OG0003274	0	8	4	1	1	14
OG0003275	0	2	1	10	1	14
OG0003276	0	9	3	1	1	14
OG0003277	0	6	0	8	0	14
OG0003278	0	12	0	2	0	14
OG0003279	0	1	0	13	0	14
OG0003280	0	2	2	9	1	14
OG0003281	0	8	0	6	0	14
OG0003282	0	4	1	9	0	14
OG0003283	0	3	6	4	1	14
OG0003284	0	5	8	1	0	14
OG0003285	0	3	1	9	1	14
OG0003286	0	2	0	12	0	14
OG0003287	0	1	10	2	1	14
OG0003288	0	14	0	0	0	14
OG0003289	0	1	10	2	1	14
OG0003290	0	5	0	9	0	14
OG0003291	0	1	0	13	0	14
OG0003292	0	11	0	3	0	14
OG0003293	0	1	0	13	0	14
OG0003294	0	14	0	0	0	14
OG0003295	0	2	0	11	1	14
OG0003296	0	4	1	8	1	14
OG0003297	0	5	0	9	0	14
OG0003298	0	2	2	10	0	14
OG0003299	0	1	6	5	2	14
OG0003300	0	12	0	1	1	14
OG0003301	0	4	0	10	0	14
OG0003302	0	9	1	4	0	14
OG0003303	0	3	4	6	1	14
OG0003304	0	1	9	2	2	14
OG0003305	0	1	8	4	1	14
OG0003306	0	3	2	3	6	14
OG0003307	0	0	14	0	0	14
OG0003308	0	0	5	7	2	14
OG0003309	0	0	3	0	11	14
OG0003310	0	0	14	0	0	14
OG0003311	0	0	14	0	0	14
OG0003312	0	0	14	0	0	14
OG0003313	0	0	14	0	0	14
OG0003314	0	0	1	13	0	14
OG0003315	0	0	14	0	0	14
OG0003316	0	0	11	0	3	14
OG0003317	0	0	1	13	0	14
OG0003318	0	0	2	11	1	14
OG0003319	0	0	3	11	0	14
OG0003320	0	0	2	12	0	14
OG0003321	0	0	0	14	0	14
OG0003322	0	0	0	14	0	14
OG0003323	0	0	0	14	0	14
OG0003324	0	0	0	14	0	14
OG0003325	0	0	0	14	0	14
OG0003326	0	0	0	14	0	14
OG0003327	0	0	0	14	0	14
OG0003328	1	5	2	4	1	13
OG0003329	1	4	2	5	1	13
OG0003330	1	3	1	7	1	13
OG0003331	5	3	1	3	1	13
OG0003332	1	0	7	4	1	13
OG0003333	4	1	3	3	2	13
OG0003334	2	5	0	5	1	13
OG0003335	2	2	2	7	0	13
OG0003336	2	2	0	9	0	13
OG0003337	2	8	2	1	0	13
OG0003338	3	6	2	1	1	13
OG0003339	6	1	1	5	0	13
OG0003340	2	1	1	8	1	13
OG0003341	3	5	0	4	1	13
OG0003342	1	3	1	7	1	13
OG0003343	3	3	0	7	0	13
OG0003344	5	1	2	4	1	13
OG0003345	2	2	3	4	2	13
OG0003346	1	4	1	6	1	13
OG0003347	1	6	2	3	1	13
OG0003348	1	6	4	1	1	13
OG0003349	3	3	2	4	1	13
OG0003350	5	2	2	3	1	13
OG0003351	7	1	1	4	0	13
OG0003352	5	1	3	3	1	13
OG0003353	11	0	2	0	0	13
OG0003354	1	6	2	4	0	13
OG0003355	1	9	1	1	1	13
OG0003356	2	6	1	4	0	13
OG0003357	4	4	2	2	1	13
OG0003358	2	2	4	4	1	13
OG0003359	2	6	2	2	1	13
OG0003360	1	7	1	1	3	13
OG0003361	1	1	5	5	1	13
OG0003362	1	4	1	6	1	13
OG0003363	1	2	2	6	2	13
OG0003364	4	1	1	6	1	13
OG0003365	7	3	0	2	1	13
OG0003366	2	4	1	5	1	13
OG0003367	1	5	0	7	0	13
OG0003368	2	5	3	2	1	13
OG0003369	2	1	2	7	1	13
OG0003370	1	1	1	9	1	13
OG0003371	1	7	1	3	1	13
OG0003372	1	8	0	2	2	13
OG0003373	1	7	1	4	0	13
OG0003374	1	12	0	0	0	13
OG0003375	1	3	1	6	2	13
OG0003376	3	7	1	1	1	13
OG0003377	2	5	1	5	0	13
OG0003378	1	9	3	0	0	13
OG0003379	2	4	1	6	0	13
OG0003380	1	4	1	6	1	13
OG0003381	2	7	3	1	0	13
OG0003382	2	4	2	5	0	13
OG0003383	2	6	3	1	1	13
OG0003384	5	2	2	4	0	13
OG0003385	3	2	1	6	1	13
OG0003386	1	5	2	4	1	13
OG0003387	1	3	2	6	1	13
OG0003388	1	5	3	4	0	13
OG0003389	5	2	1	5	0	13
OG0003390	2	5	2	3	1	13
OG0003391	4	2	1	5	1	13
OG0003392	1	2	1	9	0	13
OG0003393	1	2	1	8	1	13
OG0003394	1	3	2	6	1	13
OG0003395	1	4	1	5	2	13
OG0003396	4	0	3	1	5	13
OG0003397	2	4	2	4	1	13
OG0003398	3	2	4	3	1	13
OG0003399	1	7	2	2	1	13
OG0003400	1	4	3	4	1	13
OG0003401	1	1	1	9	1	13
OG0003402	2	3	2	5	1	13
OG0003403	4	2	2	4	1	13
OG0003404	2	6	1	3	1	13
OG0003405	2	5	1	5	0	13
OG0003406	3	4	2	3	1	13
OG0003407	1	9	1	1	1	13
OG0003408	2	3	3	4	1	13
OG0003409	1	1	1	10	0	13
OG0003410	3	1	1	8	0	13
OG0003411	2	2	1	8	0	13
OG0003412	4	3	1	4	1	13
OG0003413	1	1	2	9	0	13
OG0003414	2	1	2	8	0	13
OG0003415	2	1	4	6	0	13
OG0003416	4	5	1	3	0	13
OG0003417	4	5	1	3	0	13
OG0003418	2	1	4	5	1	13
OG0003419	1	2	1	8	1	13
OG0003420	1	1	1	9	1	13
OG0003421	2	6	1	4	0	13
OG0003422	1	3	3	5	1	13
OG0003423	2	4	1	5	1	13
OG0003424	1	6	2	3	1	13
OG0003425	1	9	2	1	0	13
OG0003426	3	3	3	4	0	13
OG0003427	2	2	4	5	0	13
OG0003428	1	4	1	6	1	13
OG0003429	1	2	4	4	2	13
OG0003430	4	4	2	2	1	13
OG0003431	2	4	1	4	2	13
OG0003432	2	1	4	4	2	13
OG0003433	1	6	2	3	1	13
OG0003434	4	1	2	4	2	13
OG0003435	2	7	2	2	0	13
OG0003436	1	1	1	4	6	13
OG0003437	2	2	2	5	2	13
OG0003438	2	7	2	1	1	13
OG0003439	1	4	1	6	1	13
OG0003440	3	1	6	2	1	13
OG0003441	3	3	1	5	1	13
OG0003442	1	1	3	8	0	13
OG0003443	1	7	1	3	1	13
OG0003444	2	3	2	6	0	13
OG0003445	2	0	10	1	0	13
OG0003446	1	8	2	2	0	13
OG0003447	3	6	1	3	0	13
OG0003448	4	2	5	2	0	13
OG0003449	3	3	1	5	1	13
OG0003450	3	6	1	2	1	13
OG0003451	2	2	3	5	1	13
OG0003452	2	6	2	3	0	13
OG0003453	1	5	2	3	2	13
OG0003454	1	4	2	5	1	13
OG0003455	2	1	2	7	1	13
OG0003456	1	1	1	10	0	13
OG0003457	3	5	2	1	2	13
OG0003458	1	6	1	3	2	13
OG0003459	2	5	1	5	0	13
OG0003460	3	6	3	1	0	13
OG0003461	1	4	1	6	1	13
OG0003462	1	6	1	5	0	13
OG0003463	3	6	2	2	0	13
OG0003464	4	0	9	0	0	13
OG0003465	5	2	1	4	1	13
OG0003466	1	6	1	5	0	13
OG0003467	1	1	4	6	1	13
OG0003468	1	2	2	7	1	13
OG0003469	1	2	1	8	1	13
OG0003470	4	4	1	4	0	13
OG0003471	3	1	1	7	1	13
OG0003472	1	9	2	1	0	13
OG0003473	2	1	2	7	1	13
OG0003474	1	1	2	8	1	13
OG0003475	1	8	1	2	1	13
OG0003476	4	6	2	0	1	13
OG0003477	2	6	3	1	1	13
OG0003478	2	1	4	5	1	13
OG0003479	1	2	1	9	0	13
OG0003480	3	2	1	6	1	13
OG0003481	2	1	2	8	0	13
OG0003482	3	1	7	2	0	13
OG0003483	3	3	4	2	1	13
OG0003484	2	5	2	4	0	13
OG0003485	2	1	2	6	2	13
OG0003486	1	2	1	8	1	13
OG0003487	2	3	2	4	2	13
OG0003488	1	6	3	2	1	13
OG0003489	1	5	1	5	1	13
OG0003490	1	7	2	3	0	13
OG0003491	1	3	2	6	1	13
OG0003492	1	5	2	5	0	13
OG0003493	1	4	2	6	0	13
OG0003494	1	4	3	4	1	13
OG0003495	3	2	1	6	1	13
OG0003496	2	1	6	4	0	13
OG0003497	2	1	4	5	1	13
OG0003498	3	2	3	5	0	13
OG0003499	3	3	6	0	1	13
OG0003500	3	2	1	6	1	13
OG0003501	1	3	1	8	0	13
OG0003502	1	5	3	3	1	13
OG0003503	1	1	1	9	1	13
OG0003504	1	1	1	10	0	13
OG0003505	1	2	4	5	1	13
OG0003506	4	2	3	4	0	13
OG0003507	3	3	3	3	1	13
OG0003508	7	1	2	1	2	13
OG0003509	13	0	0	0	0	13
OG0003510	1	5	2	4	1	13
OG0003511	1	1	2	6	3	13
OG0003512	13	0	0	0	0	13
OG0003513	1	2	4	4	2	13
OG0003514	2	3	2	5	1	13
OG0003515	2	8	1	1	1	13
OG0003516	2	4	2	5	0	13
OG0003517	1	1	3	6	2	13
OG0003518	1	0	9	0	3	13
OG0003519	1	4	1	6	1	13
OG0003520	2	3	2	5	1	13
OG0003521	1	3	2	6	1	13
OG0003522	1	3	2	6	1	13
OG0003523	2	4	2	4	1	13
OG0003524	2	1	2	7	1	13
OG0003525	1	3	5	4	0	13
OG0003526	5	2	1	5	0	13
OG0003527	2	1	1	8	1	13
OG0003528	2	1	1	8	1	13
OG0003529	5	1	7	0	0	13
OG0003530	1	6	1	3	2	13
OG0003531	2	0	1	9	1	13
OG0003532	1	2	2	8	0	13
OG0003533	1	5	1	5	1	13
OG0003534	4	4	1	3	1	13
OG0003535	3	4	3	2	1	13
OG0003536	3	5	2	2	1	13
OG0003537	2	3	4	4	0	13
OG0003538	1	2	6	3	1	13
OG0003539	2	4	3	3	1	13
OG0003540	2	7	1	2	1	13
OG0003541	1	2	2	8	0	13
OG0003542	1	7	4	1	0	13
OG0003543	1	1	6	4	1	13
OG0003544	1	3	1	7	1	13
OG0003545	3	5	1	3	1	13
OG0003546	1	8	2	2	0	13
OG0003547	1	3	1	8	0	13
OG0003548	2	4	1	6	0	13
OG0003549	1	8	1	2	1	13
OG0003550	0	3	0	10	0	13
OG0003551	0	3	1	9	0	13
OG0003552	0	8	0	5	0	13
OG0003553	0	2	3	7	1	13
OG0003554	0	2	11	0	0	13
OG0003555	0	4	1	8	0	13
OG0003556	0	12	0	1	0	13
OG0003557	0	1	3	8	1	13
OG0003558	0	7	3	2	1	13
OG0003559	0	1	11	0	1	13
OG0003560	0	5	6	2	0	13
OG0003561	0	4	1	8	0	13
OG0003562	0	4	1	7	1	13
OG0003563	0	4	0	9	0	13
OG0003564	0	7	0	6	0	13
OG0003565	0	13	0	0	0	13
OG0003566	0	3	2	8	0	13
OG0003567	0	5	0	8	0	13
OG0003568	0	7	0	6	0	13
OG0003569	0	6	2	5	0	13
OG0003570	0	4	2	7	0	13
OG0003571	0	2	10	1	0	13
OG0003572	0	10	1	2	0	13
OG0003573	0	3	0	10	0	13
OG0003574	0	12	0	1	0	13
OG0003575	0	2	0	11	0	13
OG0003576	0	12	0	0	1	13
OG0003577	0	2	4	1	6	13
OG0003578	0	6	5	1	1	13
OG0003579	0	13	0	0	0	13
OG0003580	0	4	3	6	0	13
OG0003581	0	1	1	11	0	13
OG0003582	0	9	1	2	1	13
OG0003583	0	8	0	5	0	13
OG0003584	0	1	7	3	2	13
OG0003585	0	10	2	1	0	13
OG0003586	0	8	1	4	0	13
OG0003587	0	1	4	7	1	13
OG0003588	0	2	5	3	3	13
OG0003589	0	6	0	7	0	13
OG0003590	0	5	1	7	0	13
OG0003591	0	9	2	1	1	13
OG0003592	0	2	0	11	0	13
OG0003593	0	9	1	3	0	13
OG0003594	0	4	0	8	1	13
OG0003595	0	9	2	2	0	13
OG0003596	0	10	0	3	0	13
OG0003597	0	2	1	10	0	13
OG0003598	0	4	2	7	0	13
OG0003599	0	8	0	5	0	13
OG0003600	0	5	0	8	0	13
OG0003601	0	2	4	6	1	13
OG0003602	0	1	2	10	0	13
OG0003603	0	4	2	7	0	13
OG0003604	0	5	5	2	1	13
OG0003605	0	3	3	6	1	13
OG0003606	0	8	2	2	1	13
OG0003607	0	6	5	1	1	13
OG0003608	0	8	4	1	0	13
OG0003609	0	8	1	4	0	13
OG0003610	0	1	0	12	0	13
OG0003611	0	3	1	8	1	13
OG0003612	0	4	2	6	1	13
OG0003613	0	5	0	6	2	13
OG0003614	0	7	0	6	0	13
OG0003615	0	12	0	1	0	13
OG0003616	0	1	0	12	0	13
OG0003617	0	3	0	10	0	13
OG0003618	0	2	1	8	2	13
OG0003619	0	11	0	2	0	13
OG0003620	0	8	3	1	1	13
OG0003621	0	5	1	6	1	13
OG0003622	0	3	0	10	0	13
OG0003623	0	3	0	10	0	13
OG0003624	0	10	0	3	0	13
OG0003625	0	2	1	8	2	13
OG0003626	0	3	4	5	1	13
OG0003627	0	8	1	2	2	13
OG0003628	0	3	2	7	1	13
OG0003629	0	4	0	9	0	13
OG0003630	0	4	0	9	0	13
OG0003631	0	2	7	4	0	13
OG0003632	0	1	2	9	1	13
OG0003633	0	1	0	12	0	13
OG0003634	0	1	0	12	0	13
OG0003635	0	10	1	2	0	13
OG0003636	0	1	1	9	2	13
OG0003637	0	3	1	2	7	13
OG0003638	0	4	1	8	0	13
OG0003639	0	9	0	4	0	13
OG0003640	0	3	8	1	1	13
OG0003641	0	11	2	0	0	13
OG0003642	0	2	1	9	1	13
OG0003643	0	1	7	5	0	13
OG0003644	0	10	1	1	1	13
OG0003645	0	1	2	9	1	13
OG0003646	0	0	8	2	3	13
OG0003647	0	0	13	0	0	13
OG0003648	0	0	11	2	0	13
OG0003649	0	0	12	1	0	13
OG0003650	0	0	12	0	1	13
OG0003651	0	0	8	2	3	13
OG0003652	0	0	13	0	0	13
OG0003653	0	0	13	0	0	13
OG0003654	0	0	1	12	0	13
OG0003655	0	0	5	8	0	13
OG0003656	0	0	11	2	0	13
OG0003657	0	0	1	11	1	13
OG0003658	0	0	6	7	0	13
OG0003659	0	0	1	9	3	13
OG0003660	0	0	1	12	0	13
OG0003661	0	0	1	12	0	13
OG0003662	0	0	0	12	1	13
OG0003663	0	0	0	13	0	13
OG0003664	0	0	0	13	0	13
OG0003665	0	0	0	13	0	13
OG0003666	0	0	0	12	1	13
OG0003667	0	0	0	13	0	13
OG0003668	0	0	0	13	0	13
OG0003669	0	0	0	13	0	13
OG0003670	0	0	0	13	0	13
OG0003671	3	2	1	6	0	12
OG0003672	1	1	2	8	0	12
OG0003673	1	3	1	6	1	12
OG0003674	1	3	3	4	1	12
OG0003675	9	0	1	2	0	12
OG0003676	1	6	1	3	1	12
OG0003677	1	0	8	2	1	12
OG0003678	12	0	0	0	0	12
OG0003679	4	0	2	5	1	12
OG0003680	1	6	1	3	1	12
OG0003681	1	7	1	2	1	12
OG0003682	12	0	0	0	0	12
OG0003683	3	5	1	1	2	12
OG0003684	1	1	4	4	2	12
OG0003685	1	2	3	5	1	12
OG0003686	1	5	2	4	0	12
OG0003687	2	2	3	4	1	12
OG0003688	1	1	1	9	0	12
OG0003689	1	4	2	3	2	12
OG0003690	1	5	2	3	1	12
OG0003691	1	3	2	5	1	12
OG0003692	5	4	1	1	1	12
OG0003693	1	2	1	7	1	12
OG0003694	1	2	4	4	1	12
OG0003695	6	2	1	3	0	12
OG0003696	1	5	1	4	1	12
OG0003697	3	4	3	2	0	12
OG0003698	2	3	1	5	1	12
OG0003699	1	3	1	7	0	12
OG0003700	1	3	2	5	1	12
OG0003701	1	5	2	2	2	12
OG0003702	2	1	1	7	1	12
OG0003703	4	1	1	5	1	12
OG0003704	4	5	1	1	1	12
OG0003705	3	1	2	5	1	12
OG0003706	2	5	1	3	1	12
OG0003707	2	4	1	3	2	12
OG0003708	3	3	1	4	1	12
OG0003709	2	3	2	4	1	12
OG0003710	3	4	2	3	0	12
OG0003711	3	2	1	5	1	12
OG0003712	2	1	2	6	1	12
OG0003713	1	1	1	8	1	12
OG0003714	2	1	1	8	0	12
OG0003715	1	5	2	3	1	12
OG0003716	2	2	1	4	3	12
OG0003717	6	3	2	1	0	12
OG0003718	2	4	2	4	0	12
OG0003719	4	1	4	2	1	12
OG0003720	3	2	1	5	1	12
OG0003721	1	2	1	7	1	12
OG0003722	4	1	2	4	1	12
OG0003723	3	3	1	5	0	12
OG0003724	1	2	2	6	1	12
OG0003725	1	2	2	7	0	12
OG0003726	1	5	1	3	2	12
OG0003727	2	1	6	2	1	12
OG0003728	3	3	2	4	0	12
OG0003729	3	5	1	3	0	12
OG0003730	4	3	2	2	1	12
OG0003731	1	4	2	4	1	12
OG0003732	1	4	5	2	0	12
OG0003733	4	1	2	4	1	12
OG0003734	1	6	4	1	0	12
OG0003735	5	2	3	1	1	12
OG0003736	2	1	1	7	1	12
OG0003737	2	5	2	2	1	12
OG0003738	1	2	1	7	1	12
OG0003739	1	2	2	6	1	12
OG0003740	2	2	1	6	1	12
OG0003741	2	3	1	5	1	12
OG0003742	2	4	1	5	0	12
OG0003743	2	1	1	7	1	12
OG0003744	2	2	2	6	0	12
OG0003745	1	6	1	3	1	12
OG0003746	1	4	1	5	1	12
OG0003747	2	3	0	6	1	12
OG0003748	4	3	1	2	2	12
OG0003749	2	5	2	2	1	12
OG0003750	3	5	1	2	1	12
OG0003751	2	7	1	1	1	12
OG0003752	1	3	3	4	1	12
OG0003753	1	2	1	8	0	12
OG0003754	1	2	1	7	1	12
OG0003755	1	1	4	5	1	12
OG0003756	2	4	2	3	1	12
OG0003757	6	2	1	3	0	12
OG0003758	4	1	1	6	0	12
OG0003759	6	1	1	3	1	12
OG0003760	1	2	4	4	1	12
OG0003761	2	1	4	4	1	12
OG0003762	1	4	1	6	0	12
OG0003763	2	3	4	2	1	12
OG0003764	1	4	3	3	1	12
OG0003765	6	1	2	3	0	12
OG0003766	3	2	1	6	0	12
OG0003767	1	2	3	4	2	12
OG0003768	2	5	2	2	1	12
OG0003769	1	7	1	2	1	12
OG0003770	1	2	4	5	0	12
OG0003771	1	6	2	3	0	12
OG0003772	1	5	1	4	1	12
OG0003773	4	5	2	1	0	12
OG0003774	5	1	1	4	1	12
OG0003775	4	2	1	5	0	12
OG0003776	1	8	1	2	0	12
OG0003777	4	1	2	4	1	12
OG0003778	2	6	1	2	1	12
OG0003779	1	5	3	3	0	12
OG0003780	2	0	10	0	0	12
OG0003781	4	3	1	3	1	12
OG0003782	1	3	1	6	1	12
OG0003783	1	0	2	7	2	12
OG0003784	1	3	3	5	0	12
OG0003785	1	6	1	4	0	12
OG0003786	1	4	4	2	1	12
OG0003787	1	5	1	4	1	12
OG0003788	5	4	1	1	1	12
OG0003789	1	4	1	5	1	12
OG0003790	1	3	2	6	0	12
OG0003791	1	4	1	5	1	12
OG0003792	1	4	4	3	0	12
OG0003793	1	4	2	4	1	12
OG0003794	2	3	1	5	1	12
OG0003795	2	1	4	4	1	12
OG0003796	1	3	1	6	1	12
OG0003797	2	5	1	1	3	12
OG0003798	5	1	2	4	0	12
OG0003799	10	0	1	0	1	12
OG0003800	1	10	1	0	0	12
OG0003801	5	0	7	0	0	12
OG0003802	1	4	2	4	1	12
OG0003803	3	5	1	2	1	12
OG0003804	2	3	1	6	0	12
OG0003805	4	5	1	2	0	12
OG0003806	2	5	2	2	1	12
OG0003807	1	0	4	3	4	12
OG0003808	1	2	5	3	1	12
OG0003809	2	5	1	4	0	12
OG0003810	1	1	8	1	1	12
OG0003811	1	4	1	4	2	12
OG0003812	2	3	2	4	1	12
OG0003813	1	5	2	3	1	12
OG0003814	1	5	4	1	1	12
OG0003815	2	2	4	3	1	12
OG0003816	1	2	2	6	1	12
OG0003817	1	3	1	7	0	12
OG0003818	1	3	4	3	1	12
OG0003819	3	2	2	5	0	12
OG0003820	1	1	1	8	1	12
OG0003821	2	2	2	5	1	12
OG0003822	3	3	1	3	2	12
OG0003823	1	8	1	2	0	12
OG0003824	2	1	3	5	1	12
OG0003825	1	2	4	4	1	12
OG0003826	3	2	1	5	1	12
OG0003827	1	2	1	7	1	12
OG0003828	1	6	1	3	1	12
OG0003829	3	4	3	1	1	12
OG0003830	1	7	1	2	1	12
OG0003831	5	2	2	2	1	12
OG0003832	4	2	6	0	0	12
OG0003833	4	6	0	1	1	12
OG0003834	3	1	3	3	2	12
OG0003835	7	0	4	0	1	12
OG0003836	1	2	6	2	1	12
OG0003837	2	4	2	2	2	12
OG0003838	1	2	1	7	1	12
OG0003839	4	2	1	3	2	12
OG0003840	1	4	2	4	1	12
OG0003841	1	3	1	5	2	12
OG0003842	1	5	1	4	1	12
OG0003843	2	2	1	6	1	12
OG0003844	2	2	1	7	0	12
OG0003845	5	1	1	3	2	12
OG0003846	3	1	1	6	1	12
OG0003847	3	4	2	2	1	12
OG0003848	1	2	3	6	0	12
OG0003849	7	1	2	1	1	12
OG0003850	1	4	1	6	0	12
OG0003851	1	4	4	2	1	12
OG0003852	4	0	2	6	0	12
OG0003853	4	2	3	3	0	12
OG0003854	6	2	1	2	1	12
OG0003855	1	6	1	4	0	12
OG0003856	1	5	1	5	0	12
OG0003857	2	3	4	3	0	12
OG0003858	2	1	3	5	1	12
OG0003859	4	1	2	4	1	12
OG0003860	1	6	4	1	0	12
OG0003861	2	2	3	4	1	12
OG0003862	2	3	1	5	1	12
OG0003863	2	2	2	5	1	12
OG0003864	5	1	3	2	1	12
OG0003865	1	6	1	4	0	12
OG0003866	3	0	2	5	2	12
OG0003867	1	1	2	8	0	12
OG0003868	4	1	2	4	1	12
OG0003869	1	3	2	5	1	12
OG0003870	2	3	4	2	1	12
OG0003871	1	1	3	5	2	12
OG0003872	4	1	5	1	1	12
OG0003873	4	2	3	2	1	12
OG0003874	1	3	5	2	1	12
OG0003875	2	3	2	4	1	12
OG0003876	1	6	2	2	1	12
OG0003877	1	3	1	5	2	12
OG0003878	1	4	2	4	1	12
OG0003879	2	5	1	2	2	12
OG0003880	5	1	1	5	0	12
OG0003881	1	5	0	5	1	12
OG0003882	1	3	5	1	2	12
OG0003883	1	1	1	8	1	12
OG0003884	1	5	2	4	0	12
OG0003885	3	3	3	2	1	12
OG0003886	1	3	3	4	1	12
OG0003887	1	8	1	1	1	12
OG0003888	4	1	1	5	1	12
OG0003889	2	1	4	2	3	12
OG0003890	2	5	2	2	1	12
OG0003891	1	1	2	7	1	12
OG0003892	1	1	1	8	1	12
OG0003893	4	4	1	3	0	12
OG0003894	7	1	2	1	1	12
OG0003895	1	2	2	7	0	12
OG0003896	1	3	1	6	1	12
OG0003897	1	3	2	5	1	12
OG0003898	2	3	1	5	1	12
OG0003899	1	8	1	1	1	12
OG0003900	3	4	4	1	0	12
OG0003901	2	4	1	4	1	12
OG0003902	3	1	2	5	1	12
OG0003903	5	1	1	1	4	12
OG0003904	9	0	2	1	0	12
OG0003905	1	0	5	2	4	12
OG0003906	3	4	1	4	0	12
OG0003907	1	5	2	4	0	12
OG0003908	1	1	4	4	2	12
OG0003909	3	0	9	0	0	12
OG0003910	1	1	7	1	2	12
OG0003911	1	2	4	4	1	12
OG0003912	2	1	1	7	1	12
OG0003913	3	0	0	9	0	12
OG0003914	3	2	5	1	1	12
OG0003915	1	5	1	5	0	12
OG0003916	2	6	1	2	1	12
OG0003917	1	8	1	1	1	12
OG0003918	10	0	2	0	0	12
OG0003919	2	2	4	4	0	12
OG0003920	1	4	1	5	1	12
OG0003921	1	1	2	8	0	12
OG0003922	1	0	7	2	2	12
OG0003923	1	1	2	4	4	12
OG0003924	2	4	1	5	0	12
OG0003925	3	5	2	1	1	12
OG0003926	1	1	7	3	0	12
OG0003927	1	3	3	3	2	12
OG0003928	1	6	2	3	0	12
OG0003929	2	2	2	5	1	12
OG0003930	1	1	2	6	2	12
OG0003931	3	2	3	2	2	12
OG0003932	1	6	1	3	1	12
OG0003933	3	1	4	4	0	12
OG0003934	1	7	1	3	0	12
OG0003935	1	8	1	2	0	12
OG0003936	1	2	1	8	0	12
OG0003937	2	1	1	8	0	12
OG0003938	2	4	1	5	0	12
OG0003939	1	1	3	6	1	12
OG0003940	6	2	2	1	1	12
OG0003941	6	2	2	1	1	12
OG0003942	1	4	3	3	1	12
OG0003943	2	10	0	0	0	12
OG0003944	2	1	2	6	1	12
OG0003945	5	2	2	1	2	12
OG0003946	4	0	7	0	1	12
OG0003947	1	4	1	5	1	12
OG0003948	8	2	1	1	0	12
OG0003949	1	2	1	8	0	12
OG0003950	1	3	1	6	1	12
OG0003951	2	1	1	7	1	12
OG0003952	4	1	4	3	0	12
OG0003953	1	5	1	4	1	12
OG0003954	3	3	2	3	1	12
OG0003955	4	2	2	4	0	12
OG0003956	1	4	3	3	1	12
OG0003957	1	4	1	6	0	12
OG0003958	2	5	3	2	0	12
OG0003959	1	5	1	4	1	12
OG0003960	5	1	2	3	1	12
OG0003961	1	3	1	6	1	12
OG0003962	0	4	4	4	0	12
OG0003963	0	4	1	7	0	12
OG0003964	0	5	5	1	1	12
OG0003965	0	11	1	0	0	12
OG0003966	0	3	5	3	1	12
OG0003967	0	1	3	7	1	12
OG0003968	0	6	1	4	1	12
OG0003969	0	2	1	9	0	12
OG0003970	0	7	0	5	0	12
OG0003971	0	3	6	3	0	12
OG0003972	0	4	0	8	0	12
OG0003973	0	5	2	5	0	12
OG0003974	0	1	1	9	1	12
OG0003975	0	4	0	8	0	12
OG0003976	0	6	0	6	0	12
OG0003977	0	2	0	10	0	12
OG0003978	0	5	2	4	1	12
OG0003979	0	7	0	5	0	12
OG0003980	0	8	2	1	1	12
OG0003981	0	2	2	7	1	12
OG0003982	0	2	5	0	5	12
OG0003983	0	10	1	1	0	12
OG0003984	0	8	0	4	0	12
OG0003985	0	5	0	7	0	12
OG0003986	0	2	8	2	0	12
OG0003987	0	6	0	5	1	12
OG0003988	0	3	3	6	0	12
OG0003989	0	5	7	0	0	12
OG0003990	0	6	2	4	0	12
OG0003991	0	1	3	7	1	12
OG0003992	0	10	1	1	0	12
OG0003993	0	5	0	7	0	12
OG0003994	0	2	1	9	0	12
OG0003995	0	4	3	4	1	12
OG0003996	0	3	0	9	0	12
OG0003997	0	1	0	11	0	12
OG0003998	0	2	0	10	0	12
OG0003999	0	4	1	6	1	12
OG0004000	0	3	7	2	0	12
OG0004001	0	1	8	2	1	12
OG0004002	0	7	0	5	0	12
OG0004003	0	5	1	5	1	12
OG0004004	0	5	1	5	1	12
OG0004005	0	3	0	9	0	12
OG0004006	0	3	2	7	0	12
OG0004007	0	12	0	0	0	12
OG0004008	0	4	0	8	0	12
OG0004009	0	8	1	3	0	12
OG0004010	0	5	2	4	1	12
OG0004011	0	6	2	2	2	12
OG0004012	0	2	8	2	0	12
OG0004013	0	12	0	0	0	12
OG0004014	0	8	1	2	1	12
OG0004015	0	8	1	3	0	12
OG0004016	0	10	1	1	0	12
OG0004017	0	5	2	4	1	12
OG0004018	0	10	0	0	2	12
OG0004019	0	9	1	1	1	12
OG0004020	0	12	0	0	0	12
OG0004021	0	10	2	0	0	12
OG0004022	0	1	0	10	1	12
OG0004023	0	12	0	0	0	12
OG0004024	0	1	0	11	0	12
OG0004025	0	4	2	6	0	12
OG0004026	0	11	0	1	0	12
OG0004027	0	2	4	5	1	12
OG0004028	0	7	0	5	0	12
OG0004029	0	1	11	0	0	12
OG0004030	0	4	2	5	1	12
OG0004031	0	4	0	8	0	12
OG0004032	0	3	1	8	0	12
OG0004033	0	3	0	9	0	12
OG0004034	0	5	1	5	1	12
OG0004035	0	6	1	4	1	12
OG0004036	0	3	0	9	0	12
OG0004037	0	10	2	0	0	12
OG0004038	0	6	4	1	1	12
OG0004039	0	4	4	3	1	12
OG0004040	0	4	3	4	1	12
OG0004041	0	6	5	1	0	12
OG0004042	0	3	1	3	5	12
OG0004043	0	7	0	5	0	12
OG0004044	0	4	1	4	3	12
OG0004045	0	2	5	4	1	12
OG0004046	0	6	1	4	1	12
OG0004047	0	2	0	0	10	12
OG0004048	0	2	1	8	1	12
OG0004049	0	5	1	6	0	12
OG0004050	0	1	0	11	0	12
OG0004051	0	1	5	3	3	12
OG0004052	0	3	0	9	0	12
OG0004053	0	6	0	6	0	12
OG0004054	0	1	1	8	2	12
OG0004055	0	2	10	0	0	12
OG0004056	0	3	3	4	2	12
OG0004057	0	3	0	9	0	12
OG0004058	0	1	1	10	0	12
OG0004059	0	1	7	3	1	12
OG0004060	0	1	3	5	3	12
OG0004061	0	1	1	10	0	12
OG0004062	0	1	8	3	0	12
OG0004063	0	1	5	6	0	12
OG0004064	0	3	0	7	2	12
OG0004065	0	1	8	2	1	12
OG0004066	0	1	4	5	2	12
OG0004067	0	2	4	3	3	12
OG0004068	0	0	12	0	0	12
OG0004069	0	0	5	1	6	12
OG0004070	0	0	4	6	2	12
OG0004071	0	0	10	1	1	12
OG0004072	0	0	5	7	0	12
OG0004073	0	0	7	0	5	12
OG0004074	0	0	11	1	0	12
OG0004075	0	0	3	9	0	12
OG0004076	0	0	12	0	0	12
OG0004077	0	0	2	5	5	12
OG0004078	0	0	12	0	0	12
OG0004079	0	0	11	1	0	12
OG0004080	0	0	12	0	0	12
OG0004081	0	0	5	7	0	12
OG0004082	0	0	12	0	0	12
OG0004083	0	0	12	0	0	12
OG0004084	0	0	12	0	0	12
OG0004085	0	0	1	0	11	12
OG0004086	0	0	2	10	0	12
OG0004087	0	0	1	2	9	12
OG0004088	0	0	0	12	0	12
OG0004089	0	0	0	12	0	12
OG0004090	0	0	0	12	0	12
OG0004091	0	0	0	11	1	12
OG0004092	0	0	0	12	0	12
OG0004093	0	0	0	12	0	12
OG0004094	0	0	0	12	0	12
OG0004095	0	0	0	12	0	12
OG0004096	0	0	0	12	0	12
OG0004097	0	0	0	12	0	12
OG0004098	0	0	0	12	0	12
OG0004099	0	0	0	12	0	12
OG0004100	0	0	0	12	0	12
OG0004101	0	0	0	12	0	12
OG0004102	0	0	0	1	11	12
OG0004103	0	0	0	12	0	12
OG0004104	0	0	0	12	0	12
OG0004105	2	7	1	1	0	11
OG0004106	1	7	1	1	1	11
OG0004107	1	4	2	3	1	11
OG0004108	11	0	0	0	0	11
OG0004109	1	6	0	3	1	11
OG0004110	2	4	1	3	1	11
OG0004111	4	1	3	2	1	11
OG0004112	6	2	1	1	1	11
OG0004113	1	5	1	3	1	11
OG0004114	1	0	3	6	1	11
OG0004115	2	2	1	5	1	11
OG0004116	1	1	1	8	0	11
OG0004117	2	2	3	2	2	11
OG0004118	3	3	1	2	2	11
OG0004119	1	5	1	3	1	11
OG0004120	5	3	1	2	0	11
OG0004121	2	2	1	4	2	11
OG0004122	2	0	9	0	0	11
OG0004123	4	1	3	3	0	11
OG0004124	1	2	2	4	2	11
OG0004125	6	1	2	2	0	11
OG0004126	1	5	2	2	1	11
OG0004127	1	2	1	7	0	11
OG0004128	1	3	3	3	1	11
OG0004129	3	1	3	2	2	11
OG0004130	3	0	5	1	2	11
OG0004131	4	2	3	2	0	11
OG0004132	3	1	1	5	1	11
OG0004133	1	4	2	3	1	11
OG0004134	1	3	0	6	1	11
OG0004135	2	4	1	3	1	11
OG0004136	1	4	2	2	2	11
OG0004137	1	5	1	3	1	11
OG0004138	5	3	1	1	1	11
OG0004139	4	3	3	1	0	11
OG0004140	1	2	2	3	3	11
OG0004141	1	1	1	8	0	11
OG0004142	1	2	1	6	1	11
OG0004143	1	2	4	3	1	11
OG0004144	1	3	2	5	0	11
OG0004145	2	5	1	2	1	11
OG0004146	3	3	1	2	2	11
OG0004147	2	4	3	1	1	11
OG0004148	2	2	2	5	0	11
OG0004149	4	1	1	4	1	11
OG0004150	1	3	4	2	1	11
OG0004151	2	4	1	3	1	11
OG0004152	1	1	4	4	1	11
OG0004153	6	1	1	2	1	11
OG0004154	2	6	1	1	1	11
OG0004155	3	4	1	2	1	11
OG0004156	1	2	1	6	1	11
OG0004157	1	1	2	6	1	11
OG0004158	4	3	3	1	0	11
OG0004159	2	1	2	5	1	11
OG0004160	1	7	1	1	1	11
OG0004161	2	3	2	3	1	11
OG0004162	1	4	2	4	0	11
OG0004163	1	3	1	6	0	11
OG0004164	1	2	1	7	0	11
OG0004165	4	1	1	4	1	11
OG0004166	2	4	2	2	1	11
OG0004167	1	3	3	3	1	11
OG0004168	2	3	3	2	1	11
OG0004169	2	2	3	3	1	11
OG0004170	2	2	2	4	1	11
OG0004171	3	3	2	2	1	11
OG0004172	1	3	2	4	1	11
OG0004173	1	4	2	3	1	11
OG0004174	2	4	1	2	2	11
OG0004175	3	2	4	1	1	11
OG0004176	1	2	2	5	1	11
OG0004177	3	3	1	4	0	11
OG0004178	1	1	4	4	1	11
OG0004179	2	5	1	3	0	11
OG0004180	1	1	2	6	1	11
OG0004181	1	2	2	5	1	11
OG0004182	1	1	1	6	2	11
OG0004183	1	1	4	2	3	11
OG0004184	1	2	3	3	2	11
OG0004185	2	1	2	5	1	11
OG0004186	2	5	1	2	1	11
OG0004187	1	4	1	5	0	11
OG0004188	2	1	3	4	1	11
OG0004189	2	3	1	4	1	11
OG0004190	1	5	3	1	1	11
OG0004191	1	2	7	1	0	11
OG0004192	1	4	1	4	1	11
OG0004193	2	7	1	0	1	11
OG0004194	2	2	1	6	0	11
OG0004195	1	4	3	2	1	11
OG0004196	5	1	2	2	1	11
OG0004197	1	3	1	6	0	11
OG0004198	3	1	1	5	1	11
OG0004199	10	0	1	0	0	11
OG0004200	1	1	1	8	0	11
OG0004201	2	2	3	3	1	11
OG0004202	1	1	1	8	0	11
OG0004203	1	4	1	4	1	11
OG0004204	3	2	2	3	1	11
OG0004205	2	1	1	6	1	11
OG0004206	1	5	1	4	0	11
OG0004207	2	0	1	8	0	11
OG0004208	1	6	1	3	0	11
OG0004209	1	4	3	3	0	11
OG0004210	3	3	1	4	0	11
OG0004211	1	2	1	5	2	11
OG0004212	1	2	1	5	2	11
OG0004213	2	1	4	2	2	11
OG0004214	2	3	1	4	1	11
OG0004215	2	0	1	7	1	11
OG0004216	2	4	2	2	1	11
OG0004217	1	2	3	4	1	11
OG0004218	4	1	1	2	3	11
OG0004219	3	2	3	2	1	11
OG0004220	1	1	1	6	2	11
OG0004221	2	0	3	5	1	11
OG0004222	2	1	1	5	2	11
OG0004223	1	2	1	6	1	11
OG0004224	2	2	1	5	1	11
OG0004225	2	1	1	6	1	11
OG0004226	1	3	2	4	1	11
OG0004227	1	6	1	2	1	11
OG0004228	1	9	0	1	0	11
OG0004229	4	2	1	3	1	11
OG0004230	1	3	2	3	2	11
OG0004231	4	0	6	0	1	11
OG0004232	1	3	2	5	0	11
OG0004233	1	2	1	6	1	11
OG0004234	2	7	1	1	0	11
OG0004235	7	0	4	0	0	11
OG0004236	1	3	1	4	2	11
OG0004237	3	4	1	3	0	11
OG0004238	2	2	2	4	1	11
OG0004239	1	6	1	3	0	11
OG0004240	2	2	1	5	1	11
OG0004241	2	4	2	1	2	11
OG0004242	1	1	2	5	2	11
OG0004243	3	4	1	3	0	11
OG0004244	1	6	1	2	1	11
OG0004245	1	7	1	2	0	11
OG0004246	1	4	4	1	1	11
OG0004247	1	1	5	3	1	11
OG0004248	2	0	5	0	4	11
OG0004249	1	4	1	4	1	11
OG0004250	3	2	1	5	0	11
OG0004251	1	4	2	4	0	11
OG0004252	1	2	1	6	1	11
OG0004253	3	2	1	4	1	11
OG0004254	2	4	2	2	1	11
OG0004255	1	6	1	2	1	11
OG0004256	1	3	2	4	1	11
OG0004257	3	3	1	3	1	11
OG0004258	4	1	3	3	0	11
OG0004259	5	3	1	1	1	11
OG0004260	4	2	2	2	1	11
OG0004261	1	3	1	5	1	11
OG0004262	2	2	2	4	1	11
OG0004263	2	1	1	6	1	11
OG0004264	1	4	2	3	1	11
OG0004265	11	0	0	0	0	11
OG0004266	2	4	2	2	1	11
OG0004267	4	0	2	4	1	11
OG0004268	3	3	3	2	0	11
OG0004269	2	3	1	4	1	11
OG0004270	1	1	1	7	1	11
OG0004271	3	0	8	0	0	11
OG0004272	1	6	1	2	1	11
OG0004273	2	1	3	4	1	11
OG0004274	3	4	1	2	1	11
OG0004275	1	1	2	7	0	11
OG0004276	4	0	7	0	0	11
OG0004277	6	0	5	0	0	11
OG0004278	5	1	2	3	0	11
OG0004279	1	7	2	1	0	11
OG0004280	3	3	2	2	1	11
OG0004281	1	1	2	6	1	11
OG0004282	3	1	2	4	1	11
OG0004283	10	1	0	0	0	11
OG0004284	1	5	1	4	0	11
OG0004285	1	3	1	6	0	11
OG0004286	1	1	4	4	1	11
OG0004287	1	2	3	2	3	11
OG0004288	2	6	1	1	1	11
OG0004289	1	1	1	7	1	11
OG0004290	3	3	1	3	1	11
OG0004291	4	1	1	4	1	11
OG0004292	2	2	2	5	0	11
OG0004293	1	6	1	3	0	11
OG0004294	1	1	2	6	1	11
OG0004295	1	1	4	5	0	11
OG0004296	3	1	1	5	1	11
OG0004297	2	2	4	2	1	11
OG0004298	3	7	0	0	1	11
OG0004299	1	4	3	2	1	11
OG0004300	3	1	1	5	1	11
OG0004301	3	2	1	5	0	11
OG0004302	2	3	2	4	0	11
OG0004303	1	4	1	4	1	11
OG0004304	2	2	1	5	1	11
OG0004305	6	1	2	1	1	11
OG0004306	1	1	3	5	1	11
OG0004307	2	1	5	2	1	11
OG0004308	5	3	1	1	1	11
OG0004309	2	3	1	5	0	11
OG0004310	10	0	1	0	0	11
OG0004311	2	1	6	2	0	11
OG0004312	1	5	1	3	1	11
OG0004313	1	2	1	7	0	11
OG0004314	1	6	1	3	0	11
OG0004315	1	1	5	3	1	11
OG0004316	1	4	3	3	0	11
OG0004317	1	2	3	4	1	11
OG0004318	1	1	3	6	0	11
OG0004319	2	4	1	4	0	11
OG0004320	1	1	1	7	1	11
OG0004321	1	8	1	1	0	11
OG0004322	1	3	5	2	0	11
OG0004323	2	2	2	3	2	11
OG0004324	1	1	3	6	0	11
OG0004325	5	3	3	0	0	11
OG0004326	3	4	1	1	2	11
OG0004327	1	4	1	4	1	11
OG0004328	3	3	1	4	0	11
OG0004329	2	2	1	5	1	11
OG0004330	1	6	1	3	0	11
OG0004331	2	2	2	4	1	11
OG0004332	2	5	0	4	0	11
OG0004333	3	3	1	4	0	11
OG0004334	1	2	1	6	1	11
OG0004335	2	2	1	6	0	11
OG0004336	1	5	1	4	0	11
OG0004337	2	4	2	2	1	11
OG0004338	1	0	2	7	1	11
OG0004339	1	3	1	3	3	11
OG0004340	2	6	1	1	1	11
OG0004341	5	3	1	1	1	11
OG0004342	3	5	0	2	1	11
OG0004343	3	5	1	2	0	11
OG0004344	3	2	1	4	1	11
OG0004345	2	2	3	3	1	11
OG0004346	2	1	3	4	1	11
OG0004347	1	2	1	6	1	11
OG0004348	1	4	1	3	2	11
OG0004349	3	4	0	3	1	11
OG0004350	2	3	2	3	1	11
OG0004351	1	1	2	6	1	11
OG0004352	2	1	7	1	0	11
OG0004353	1	5	1	3	1	11
OG0004354	1	2	5	2	1	11
OG0004355	2	2	1	5	1	11
OG0004356	3	2	1	4	1	11
OG0004357	2	2	1	5	1	11
OG0004358	1	3	4	2	1	11
OG0004359	3	0	7	1	0	11
OG0004360	6	3	1	1	0	11
OG0004361	3	1	1	5	1	11
OG0004362	4	3	1	2	1	11
OG0004363	1	3	1	4	2	11
OG0004364	1	1	2	4	3	11
OG0004365	4	1	3	3	0	11
OG0004366	1	2	1	7	0	11
OG0004367	3	1	0	6	1	11
OG0004368	5	3	1	1	1	11
OG0004369	1	8	1	1	0	11
OG0004370	2	3	1	3	2	11
OG0004371	1	6	1	2	1	11
OG0004372	1	2	2	5	1	11
OG0004373	3	2	2	3	1	11
OG0004374	1	1	0	8	1	11
OG0004375	3	1	2	5	0	11
OG0004376	2	1	1	6	1	11
OG0004377	1	3	2	4	1	11
OG0004378	2	3	1	3	2	11
OG0004379	2	2	1	4	2	11
OG0004380	2	3	1	4	1	11
OG0004381	2	4	2	2	1	11
OG0004382	3	1	1	5	1	11
OG0004383	1	2	2	6	0	11
OG0004384	3	5	1	2	0	11
OG0004385	2	2	5	2	0	11
OG0004386	2	0	0	9	0	11
OG0004387	1	2	2	6	0	11
OG0004388	2	2	2	4	1	11
OG0004389	1	3	1	5	1	11
OG0004390	1	2	1	7	0	11
OG0004391	1	5	1	4	0	11
OG0004392	1	6	1	2	1	11
OG0004393	1	6	1	3	0	11
OG0004394	1	6	1	2	1	11
OG0004395	4	3	1	2	1	11
OG0004396	3	2	2	4	0	11
OG0004397	1	6	2	2	0	11
OG0004398	1	0	6	1	3	11
OG0004399	10	0	0	0	1	11
OG0004400	2	3	3	2	1	11
OG0004401	1	1	1	7	1	11
OG0004402	1	0	0	7	3	11
OG0004403	1	0	1	6	3	11
OG0004404	7	0	1	0	3	11
OG0004405	7	1	1	1	1	11
OG0004406	2	3	2	3	1	11
OG0004407	1	3	1	5	1	11
OG0004408	1	1	1	6	2	11
OG0004409	1	1	2	6	1	11
OG0004410	3	3	2	3	0	11
OG0004411	2	2	1	5	1	11
OG0004412	1	5	1	3	1	11
OG0004413	2	3	2	4	0	11
OG0004414	1	4	3	2	1	11
OG0004415	1	1	1	7	1	11
OG0004416	9	0	0	0	2	11
OG0004417	1	7	0	2	1	11
OG0004418	1	3	2	5	0	11
OG0004419	1	4	2	1	3	11
OG0004420	1	1	5	3	1	11
OG0004421	1	3	3	4	0	11
OG0004422	3	0	7	0	1	11
OG0004423	2	0	5	0	4	11
OG0004424	1	0	3	0	7	11
OG0004425	1	4	4	1	1	11
OG0004426	2	6	0	2	1	11
OG0004427	1	6	3	1	0	11
OG0004428	2	1	4	1	3	11
OG0004429	1	6	0	3	1	11
OG0004430	1	5	1	3	1	11
OG0004431	1	4	2	3	1	11
OG0004432	2	2	2	4	1	11
OG0004433	1	2	5	1	2	11
OG0004434	1	2	2	5	1	11
OG0004435	1	2	2	5	1	11
OG0004436	1	2	4	3	1	11
OG0004437	2	1	0	7	1	11
OG0004438	3	3	3	2	0	11
OG0004439	0	4	0	7	0	11
OG0004440	0	11	0	0	0	11
OG0004441	0	7	0	3	1	11
OG0004442	0	2	0	9	0	11
OG0004443	0	1	7	2	1	11
OG0004444	0	3	2	5	1	11
OG0004445	0	4	0	7	0	11
OG0004446	0	5	0	6	0	11
OG0004447	0	6	2	3	0	11
OG0004448	0	6	2	2	1	11
OG0004449	0	1	1	9	0	11
OG0004450	0	8	1	1	1	11
OG0004451	0	2	7	2	0	11
OG0004452	0	3	4	4	0	11
OG0004453	0	3	1	7	0	11
OG0004454	0	5	0	6	0	11
OG0004455	0	3	8	0	0	11
OG0004456	0	3	0	8	0	11
OG0004457	0	3	4	3	1	11
OG0004458	0	6	2	3	0	11
OG0004459	0	5	1	5	0	11
OG0004460	0	3	2	6	0	11
OG0004461	0	6	1	3	1	11
OG0004462	0	6	0	5	0	11
OG0004463	0	5	3	2	1	11
OG0004464	0	5	1	3	2	11
OG0004465	0	7	1	2	1	11
OG0004466	0	4	2	5	0	11
OG0004467	0	4	0	0	7	11
OG0004468	0	9	0	2	0	11
OG0004469	0	3	1	7	0	11
OG0004470	0	10	1	0	0	11
OG0004471	0	1	0	10	0	11
OG0004472	0	6	3	2	0	11
OG0004473	0	2	6	2	1	11
OG0004474	0	1	0	8	2	11
OG0004475	0	5	0	6	0	11
OG0004476	0	2	2	3	4	11
OG0004477	0	1	0	9	1	11
OG0004478	0	8	0	3	0	11
OG0004479	0	4	2	4	1	11
OG0004480	0	4	5	2	0	11
OG0004481	0	2	0	9	0	11
OG0004482	0	10	0	1	0	11
OG0004483	0	5	0	6	0	11
OG0004484	0	9	0	2	0	11
OG0004485	0	1	3	6	1	11
OG0004486	0	3	0	8	0	11
OG0004487	0	4	1	5	1	11
OG0004488	0	7	0	4	0	11
OG0004489	0	6	0	5	0	11
OG0004490	0	10	0	1	0	11
OG0004491	0	2	8	0	1	11
OG0004492	0	6	0	5	0	11
OG0004493	0	3	1	7	0	11
OG0004494	0	7	0	4	0	11
OG0004495	0	6	2	3	0	11
OG0004496	0	4	0	7	0	11
OG0004497	0	8	3	0	0	11
OG0004498	0	5	2	3	1	11
OG0004499	0	4	0	5	2	11
OG0004500	0	8	2	1	0	11
OG0004501	0	11	0	0	0	11
OG0004502	0	4	0	7	0	11
OG0004503	0	5	4	2	0	11
OG0004504	0	11	0	0	0	11
OG0004505	0	2	0	8	1	11
OG0004506	0	2	3	5	1	11
OG0004507	0	9	0	2	0	11
OG0004508	0	1	1	7	2	11
OG0004509	0	4	1	4	2	11
OG0004510	0	2	0	1	8	11
OG0004511	0	1	2	8	0	11
OG0004512	0	7	1	2	1	11
OG0004513	0	5	1	4	1	11
OG0004514	0	2	1	8	0	11
OG0004515	0	2	1	6	2	11
OG0004516	0	3	0	8	0	11
OG0004517	0	4	2	4	1	11
OG0004518	0	5	4	1	1	11
OG0004519	0	2	2	4	3	11
OG0004520	0	3	2	6	0	11
OG0004521	0	2	0	9	0	11
OG0004522	0	2	1	7	1	11
OG0004523	0	3	5	3	0	11
OG0004524	0	8	2	1	0	11
OG0004525	0	9	1	0	1	11
OG0004526	0	10	0	0	1	11
OG0004527	0	4	2	5	0	11
OG0004528	0	6	1	4	0	11
OG0004529	0	4	4	3	0	11
OG0004530	0	3	0	8	0	11
OG0004531	0	3	4	4	0	11
OG0004532	0	5	0	5	1	11
OG0004533	0	4	3	2	2	11
OG0004534	0	8	2	1	0	11
OG0004535	0	1	1	8	1	11
OG0004536	0	4	2	4	1	11
OG0004537	0	2	6	1	2	11
OG0004538	0	4	0	7	0	11
OG0004539	0	8	0	3	0	11
OG0004540	0	1	0	10	0	11
OG0004541	0	8	0	3	0	11
OG0004542	0	8	2	1	0	11
OG0004543	0	1	1	8	1	11
OG0004544	0	1	0	9	1	11
OG0004545	0	1	7	2	1	11
OG0004546	0	1	3	6	1	11
OG0004547	0	1	6	3	1	11
OG0004548	0	1	2	6	2	11
OG0004549	0	1	4	4	2	11
OG0004550	0	1	3	7	0	11
OG0004551	0	1	3	5	2	11
OG0004552	0	1	1	9	0	11
OG0004553	0	0	3	8	0	11
OG0004554	0	0	1	10	0	11
OG0004555	0	0	10	0	1	11
OG0004556	0	0	11	0	0	11
OG0004557	0	0	8	2	1	11
OG0004558	0	0	9	2	0	11
OG0004559	0	0	11	0	0	11
OG0004560	0	0	10	0	1	11
OG0004561	0	0	11	0	0	11
OG0004562	0	0	11	0	0	11
OG0004563	0	0	4	7	0	11
OG0004564	0	0	2	0	9	11
OG0004565	0	0	6	4	1	11
OG0004566	0	0	6	2	3	11
OG0004567	0	0	11	0	0	11
OG0004568	0	0	9	1	1	11
OG0004569	0	0	6	3	2	11
OG0004570	0	0	10	0	1	11
OG0004571	0	0	8	2	1	11
OG0004572	0	0	11	0	0	11
OG0004573	0	0	11	0	0	11
OG0004574	0	0	3	0	8	11
OG0004575	0	0	10	0	1	11
OG0004576	0	0	2	9	0	11
OG0004577	0	0	1	10	0	11
OG0004578	0	0	1	10	0	11
OG0004579	0	0	0	11	0	11
OG0004580	0	0	0	11	0	11
OG0004581	0	0	0	11	0	11
OG0004582	0	0	0	11	0	11
OG0004583	0	0	0	11	0	11
OG0004584	0	0	0	11	0	11
OG0004585	0	0	0	11	0	11
OG0004586	0	0	0	10	1	11
OG0004587	0	0	0	11	0	11
OG0004588	0	0	0	10	1	11
OG0004589	0	0	0	11	0	11
OG0004590	0	0	0	0	11	11
OG0004591	0	0	0	0	11	11
OG0004592	0	0	0	0	11	11
OG0004593	1	2	1	6	0	10
OG0004594	1	1	3	5	0	10
OG0004595	4	0	0	0	6	10
OG0004596	1	2	2	3	2	10
OG0004597	1	5	1	2	1	10
OG0004598	1	3	2	3	1	10
OG0004599	1	3	1	5	0	10
OG0004600	1	1	2	5	1	10
OG0004601	1	2	2	4	1	10
OG0004602	1	2	3	3	1	10
OG0004603	2	4	2	1	1	10
OG0004604	2	4	1	3	0	10
OG0004605	4	3	1	2	0	10
OG0004606	1	2	2	4	1	10
OG0004607	4	1	1	3	1	10
OG0004608	2	2	4	2	0	10
OG0004609	10	0	0	0	0	10
OG0004610	1	2	4	2	1	10
OG0004611	7	0	1	1	1	10
OG0004612	2	2	1	4	1	10
OG0004613	1	0	9	0	0	10
OG0004614	9	0	1	0	0	10
OG0004615	10	0	0	0	0	10
OG0004616	2	3	3	2	0	10
OG0004617	1	3	1	4	1	10
OG0004618	2	4	2	1	1	10
OG0004619	2	3	3	2	0	10
OG0004620	3	2	3	1	1	10
OG0004621	1	2	3	3	1	10
OG0004622	1	5	1	2	1	10
OG0004623	2	4	1	2	1	10
OG0004624	2	4	2	1	1	10
OG0004625	1	2	1	5	1	10
OG0004626	1	2	1	6	0	10
OG0004627	2	2	2	3	1	10
OG0004628	2	2	3	3	0	10
OG0004629	1	3	2	3	1	10
OG0004630	1	2	3	3	1	10
OG0004631	1	2	1	6	0	10
OG0004632	2	3	1	2	2	10
OG0004633	3	1	1	4	1	10
OG0004634	3	1	2	3	1	10
OG0004635	3	0	2	3	2	10
OG0004636	2	1	2	3	2	10
OG0004637	1	4	1	4	0	10
OG0004638	2	2	2	3	1	10
OG0004639	2	3	1	2	2	10
OG0004640	2	3	1	3	1	10
OG0004641	1	2	2	5	0	10
OG0004642	1	3	3	3	0	10
OG0004643	5	1	1	2	1	10
OG0004644	1	2	1	5	1	10
OG0004645	1	4	3	1	1	10
OG0004646	2	1	4	2	1	10
OG0004647	1	4	1	4	0	10
OG0004648	1	2	2	4	1	10
OG0004649	2	1	2	4	1	10
OG0004650	1	4	1	4	0	10
OG0004651	4	1	1	4	0	10
OG0004652	3	3	1	3	0	10
OG0004653	2	1	1	5	1	10
OG0004654	1	1	4	3	1	10
OG0004655	3	1	2	2	2	10
OG0004656	1	5	1	2	1	10
OG0004657	1	4	1	2	2	10
OG0004658	2	0	1	7	0	10
OG0004659	1	1	7	1	0	10
OG0004660	1	3	1	4	1	10
OG0004661	2	3	2	3	0	10
OG0004662	2	0	8	0	0	10
OG0004663	1	7	1	1	0	10
OG0004664	1	1	1	6	1	10
OG0004665	7	0	1	2	0	10
OG0004666	3	1	1	4	1	10
OG0004667	2	4	1	3	0	10
OG0004668	1	4	3	1	1	10
OG0004669	3	0	6	0	1	10
OG0004670	3	2	2	2	1	10
OG0004671	2	4	1	2	1	10
OG0004672	1	1	2	4	2	10
OG0004673	3	3	1	2	1	10
OG0004674	1	4	1	3	1	10
OG0004675	2	1	2	4	1	10
OG0004676	5	0	5	0	0	10
OG0004677	3	2	3	2	0	10
OG0004678	1	2	1	6	0	10
OG0004679	2	3	3	2	0	10
OG0004680	1	3	3	3	0	10
OG0004681	2	2	2	3	1	10
OG0004682	1	1	1	6	1	10
OG0004683	1	1	1	6	1	10
OG0004684	1	2	2	5	0	10
OG0004685	1	1	1	6	1	10
OG0004686	2	1	2	4	1	10
OG0004687	1	2	1	6	0	10
OG0004688	1	3	1	4	1	10
OG0004689	2	3	1	4	0	10
OG0004690	2	1	2	4	1	10
OG0004691	2	3	2	2	1	10
OG0004692	3	3	2	1	1	10
OG0004693	8	0	2	0	0	10
OG0004694	1	3	2	4	0	10
OG0004695	1	5	1	2	1	10
OG0004696	1	3	1	4	1	10
OG0004697	4	1	1	3	1	10
OG0004698	1	4	2	2	1	10
OG0004699	1	1	1	7	0	10
OG0004700	1	2	1	5	1	10
OG0004701	2	2	1	4	1	10
OG0004702	3	1	3	2	1	10
OG0004703	2	1	1	5	1	10
OG0004704	1	3	1	4	1	10
OG0004705	1	1	3	4	1	10
OG0004706	3	3	2	1	1	10
OG0004707	1	1	1	6	1	10
OG0004708	2	1	1	4	2	10
OG0004709	4	1	1	4	0	10
OG0004710	1	4	1	4	0	10
OG0004711	1	5	1	2	1	10
OG0004712	1	2	6	1	0	10
OG0004713	2	3	1	3	1	10
OG0004714	1	4	3	1	1	10
OG0004715	1	5	1	2	1	10
OG0004716	2	1	1	5	1	10
OG0004717	1	2	1	5	1	10
OG0004718	1	5	1	2	1	10
OG0004719	1	4	2	2	1	10
OG0004720	1	2	3	3	1	10
OG0004721	3	1	5	1	0	10
OG0004722	10	0	0	0	0	10
OG0004723	1	3	1	5	0	10
OG0004724	1	4	2	1	2	10
OG0004725	2	3	2	3	0	10
OG0004726	2	3	1	3	1	10
OG0004727	1	1	1	6	1	10
OG0004728	1	4	1	4	0	10
OG0004729	1	5	2	2	0	10
OG0004730	1	1	3	4	1	10
OG0004731	2	0	2	6	0	10
OG0004732	1	5	1	2	1	10
OG0004733	2	2	1	2	3	10
OG0004734	3	3	1	3	0	10
OG0004735	1	1	3	4	1	10
OG0004736	1	2	1	5	1	10
OG0004737	2	2	1	4	1	10
OG0004738	1	2	2	5	0	10
OG0004739	1	3	1	5	0	10
OG0004740	1	1	1	6	1	10
OG0004741	1	1	3	2	3	10
OG0004742	1	1	2	6	0	10
OG0004743	3	1	1	4	1	10
OG0004744	2	4	1	3	0	10
OG0004745	1	2	1	6	0	10
OG0004746	1	2	2	5	0	10
OG0004747	1	4	1	3	1	10
OG0004748	1	0	6	1	2	10
OG0004749	1	1	2	5	1	10
OG0004750	2	4	0	3	1	10
OG0004751	2	4	2	1	1	10
OG0004752	2	2	1	3	2	10
OG0004753	1	3	2	2	2	10
OG0004754	1	3	2	4	0	10
OG0004755	3	4	1	2	0	10
OG0004756	1	2	1	5	1	10
OG0004757	1	1	3	5	0	10
OG0004758	2	2	1	4	1	10
OG0004759	1	4	1	4	0	10
OG0004760	1	3	4	0	2	10
OG0004761	1	3	2	3	1	10
OG0004762	1	3	1	4	1	10
OG0004763	4	0	4	2	0	10
OG0004764	1	2	1	4	2	10
OG0004765	1	2	3	4	0	10
OG0004766	1	2	1	5	1	10
OG0004767	1	2	1	5	1	10
OG0004768	1	3	2	3	1	10
OG0004769	2	4	1	2	1	10
OG0004770	1	4	1	3	1	10
OG0004771	2	5	1	2	0	10
OG0004772	5	1	2	1	1	10
OG0004773	1	1	3	5	0	10
OG0004774	1	4	2	1	2	10
OG0004775	3	3	2	2	0	10
OG0004776	2	2	3	2	1	10
OG0004777	6	1	1	2	0	10
OG0004778	2	1	1	5	1	10
OG0004779	10	0	0	0	0	10
OG0004780	2	2	3	2	1	10
OG0004781	1	3	2	3	1	10
OG0004782	3	2	1	3	1	10
OG0004783	1	3	1	4	1	10
OG0004784	2	0	1	3	4	10
OG0004785	2	2	1	4	1	10
OG0004786	1	2	4	2	1	10
OG0004787	1	0	1	8	0	10
OG0004788	2	2	1	3	2	10
OG0004789	1	1	2	4	2	10
OG0004790	1	4	3	1	1	10
OG0004791	1	0	2	6	1	10
OG0004792	1	3	1	5	0	10
OG0004793	2	2	1	4	1	10
OG0004794	2	2	1	3	2	10
OG0004795	1	3	1	5	0	10
OG0004796	2	2	3	2	1	10
OG0004797	2	2	5	1	0	10
OG0004798	6	1	1	1	1	10
OG0004799	1	6	1	1	1	10
OG0004800	3	0	1	6	0	10
OG0004801	1	0	2	6	1	10
OG0004802	1	2	1	5	1	10
OG0004803	2	1	6	1	0	10
OG0004804	2	4	1	2	1	10
OG0004805	2	2	4	1	1	10
OG0004806	1	5	1	2	1	10
OG0004807	1	6	1	1	1	10
OG0004808	1	3	2	3	1	10
OG0004809	1	3	3	2	1	10
OG0004810	1	2	0	7	0	10
OG0004811	3	1	2	3	1	10
OG0004812	2	3	1	4	0	10
OG0004813	1	1	3	3	2	10
OG0004814	1	2	2	5	0	10
OG0004815	1	1	3	4	1	10
OG0004816	1	2	1	5	1	10
OG0004817	2	5	1	1	1	10
OG0004818	1	1	2	6	0	10
OG0004819	4	1	1	3	1	10
OG0004820	1	0	1	7	1	10
OG0004821	1	2	0	6	1	10
OG0004822	4	1	2	2	1	10
OG0004823	1	6	1	2	0	10
OG0004824	1	5	2	1	1	10
OG0004825	4	2	1	2	1	10
OG0004826	2	2	1	4	1	10
OG0004827	2	2	2	4	0	10
OG0004828	1	2	2	4	1	10
OG0004829	1	1	1	6	1	10
OG0004830	1	3	1	4	1	10
OG0004831	1	4	3	2	0	10
OG0004832	3	3	2	1	1	10
OG0004833	3	1	4	1	1	10
OG0004834	1	1	1	6	1	10
OG0004835	1	2	2	4	1	10
OG0004836	4	1	1	4	0	10
OG0004837	3	3	3	1	0	10
OG0004838	2	3	1	3	1	10
OG0004839	1	2	4	2	1	10
OG0004840	1	3	1	4	1	10
OG0004841	1	3	2	4	0	10
OG0004842	3	2	2	2	1	10
OG0004843	1	1	4	2	2	10
OG0004844	2	0	4	3	1	10
OG0004845	1	3	1	4	1	10
OG0004846	3	3	1	3	0	10
OG0004847	5	0	1	3	1	10
OG0004848	1	4	1	2	2	10
OG0004849	3	3	1	1	2	10
OG0004850	1	1	1	6	1	10
OG0004851	3	2	2	1	2	10
OG0004852	7	0	1	1	1	10
OG0004853	3	3	1	3	0	10
OG0004854	2	6	0	2	0	10
OG0004855	1	4	1	4	0	10
OG0004856	1	4	3	2	0	10
OG0004857	1	2	1	5	1	10
OG0004858	9	0	0	0	1	10
OG0004859	4	2	2	1	1	10
OG0004860	1	1	1	6	1	10
OG0004861	1	1	3	4	1	10
OG0004862	1	3	3	2	1	10
OG0004863	2	0	1	6	1	10
OG0004864	2	1	1	6	0	10
OG0004865	1	2	1	5	1	10
OG0004866	4	2	2	1	1	10
OG0004867	2	4	2	1	1	10
OG0004868	1	1	1	6	1	10
OG0004869	3	3	1	3	0	10
OG0004870	1	2	1	6	0	10
OG0004871	2	1	2	4	1	10
OG0004872	4	2	1	2	1	10
OG0004873	2	3	1	4	0	10
OG0004874	1	2	2	5	0	10
OG0004875	4	1	1	3	1	10
OG0004876	2	2	2	4	0	10
OG0004877	1	2	1	5	1	10
OG0004878	3	3	1	2	1	10
OG0004879	2	0	0	8	0	10
OG0004880	1	1	2	5	1	10
OG0004881	1	2	1	6	0	10
OG0004882	2	0	2	5	1	10
OG0004883	2	1	2	2	3	10
OG0004884	3	1	3	3	0	10
OG0004885	2	2	2	2	2	10
OG0004886	1	5	1	2	1	10
OG0004887	1	3	1	4	1	10
OG0004888	10	0	0	0	0	10
OG0004889	3	3	3	1	0	10
OG0004890	1	2	2	4	1	10
OG0004891	3	3	1	2	1	10
OG0004892	3	2	1	3	1	10
OG0004893	1	3	1	5	0	10
OG0004894	3	1	2	4	0	10
OG0004895	1	3	2	2	2	10
OG0004896	1	4	1	3	1	10
OG0004897	1	6	1	1	1	10
OG0004898	5	0	4	1	0	10
OG0004899	1	1	1	7	0	10
OG0004900	1	4	2	2	1	10
OG0004901	1	5	2	1	1	10
OG0004902	1	2	1	5	1	10
OG0004903	1	6	1	1	1	10
OG0004904	1	2	1	5	1	10
OG0004905	1	3	3	2	1	10
OG0004906	5	1	1	1	2	10
OG0004907	2	1	3	2	2	10
OG0004908	2	3	3	2	0	10
OG0004909	2	2	2	4	0	10
OG0004910	3	2	1	3	1	10
OG0004911	2	1	2	5	0	10
OG0004912	1	6	1	1	1	10
OG0004913	8	0	0	0	2	10
OG0004914	1	1	4	2	2	10
OG0004915	1	2	1	6	0	10
OG0004916	1	1	1	7	0	10
OG0004917	2	4	2	1	1	10
OG0004918	1	3	1	4	1	10
OG0004919	2	1	1	5	1	10
OG0004920	10	0	0	0	0	10
OG0004921	1	3	1	4	1	10
OG0004922	1	0	0	9	0	10
OG0004923	2	1	4	2	1	10
OG0004924	1	4	2	2	1	10
OG0004925	2	5	2	1	0	10
OG0004926	1	5	2	1	1	10
OG0004927	3	1	1	4	1	10
OG0004928	1	0	8	0	1	10
OG0004929	1	3	2	3	1	10
OG0004930	5	2	1	1	1	10
OG0004931	2	2	2	3	1	10
OG0004932	1	4	2	3	0	10
OG0004933	1	5	2	2	0	10
OG0004934	1	1	5	3	0	10
OG0004935	1	2	1	6	0	10
OG0004936	1	2	2	4	1	10
OG0004937	2	1	1	5	1	10
OG0004938	2	2	5	1	0	10
OG0004939	1	1	3	5	0	10
OG0004940	1	5	2	1	1	10
OG0004941	1	1	1	6	1	10
OG0004942	3	3	1	2	1	10
OG0004943	3	1	1	5	0	10
OG0004944	1	4	2	2	1	10
OG0004945	1	0	1	7	1	10
OG0004946	1	2	7	0	0	10
OG0004947	6	1	1	1	1	10
OG0004948	1	1	1	7	0	10
OG0004949	1	3	2	3	1	10
OG0004950	1	4	1	2	2	10
OG0004951	2	1	4	2	1	10
OG0004952	2	3	1	4	0	10
OG0004953	1	1	2	5	1	10
OG0004954	2	1	2	4	1	10
OG0004955	3	1	2	4	0	10
OG0004956	1	5	2	1	1	10
OG0004957	7	0	1	1	1	10
OG0004958	2	1	4	2	1	10
OG0004959	3	0	6	0	1	10
OG0004960	1	2	1	6	0	10
OG0004961	4	2	1	2	1	10
OG0004962	1	3	2	3	1	10
OG0004963	1	2	1	4	2	10
OG0004964	2	2	4	1	1	10
OG0004965	1	2	1	3	3	10
OG0004966	6	1	1	2	0	10
OG0004967	0	4	1	4	1	10
OG0004968	0	4	1	5	0	10
OG0004969	0	3	2	5	0	10
OG0004970	0	1	1	7	1	10
OG0004971	0	3	0	7	0	10
OG0004972	0	3	4	2	1	10
OG0004973	0	7	2	1	0	10
OG0004974	0	2	0	8	0	10
OG0004975	0	1	0	9	0	10
OG0004976	0	7	0	3	0	10
OG0004977	0	3	3	2	2	10
OG0004978	0	1	2	6	1	10
OG0004979	0	2	0	8	0	10
OG0004980	0	6	2	1	1	10
OG0004981	0	1	3	6	0	10
OG0004982	0	2	2	5	1	10
OG0004983	0	2	1	7	0	10
OG0004984	0	2	0	8	0	10
OG0004985	0	4	0	6	0	10
OG0004986	0	7	0	3	0	10
OG0004987	0	1	0	5	4	10
OG0004988	0	9	0	1	0	10
OG0004989	0	1	3	6	0	10
OG0004990	0	3	4	2	1	10
OG0004991	0	2	0	8	0	10
OG0004992	0	4	2	4	0	10
OG0004993	0	2	2	5	1	10
OG0004994	0	1	1	8	0	10
OG0004995	0	2	2	6	0	10
OG0004996	0	4	0	6	0	10
OG0004997	0	3	0	2	5	10
OG0004998	0	3	2	4	1	10
OG0004999	0	5	0	5	0	10
OG0005000	0	3	2	5	0	10
OG0005001	0	9	0	0	1	10
OG0005002	0	2	0	8	0	10
OG0005003	0	1	2	7	0	10
OG0005004	0	3	1	6	0	10
OG0005005	0	4	4	1	1	10
OG0005006	0	2	1	5	2	10
OG0005007	0	1	0	9	0	10
OG0005008	0	6	1	2	1	10
OG0005009	0	3	1	5	1	10
OG0005010	0	8	0	2	0	10
OG0005011	0	4	0	6	0	10
OG0005012	0	3	1	5	1	10
OG0005013	0	3	0	7	0	10
OG0005014	0	2	2	5	1	10
OG0005015	0	2	4	4	0	10
OG0005016	0	1	7	2	0	10
OG0005017	0	1	0	9	0	10
OG0005018	0	2	1	6	1	10
OG0005019	0	1	3	6	0	10
OG0005020	0	10	0	0	0	10
OG0005021	0	1	0	9	0	10
OG0005022	0	2	5	2	1	10
OG0005023	0	4	3	2	1	10
OG0005024	0	2	4	4	0	10
OG0005025	0	6	2	0	2	10
OG0005026	0	5	1	4	0	10
OG0005027	0	5	1	3	1	10
OG0005028	0	7	2	0	1	10
OG0005029	0	6	1	2	1	10
OG0005030	0	4	1	5	0	10
OG0005031	0	4	0	6	0	10
OG0005032	0	1	0	9	0	10
OG0005033	0	6	0	4	0	10
OG0005034	0	3	3	4	0	10
OG0005035	0	4	1	4	1	10
OG0005036	0	3	1	6	0	10
OG0005037	0	1	2	7	0	10
OG0005038	0	5	0	5	0	10
OG0005039	0	2	7	1	0	10
OG0005040	0	6	0	4	0	10
OG0005041	0	6	2	2	0	10
OG0005042	0	5	1	3	1	10
OG0005043	0	7	1	1	1	10
OG0005044	0	4	0	6	0	10
OG0005045	0	6	2	1	1	10
OG0005046	0	5	3	2	0	10
OG0005047	0	6	0	4	0	10
OG0005048	0	4	1	5	0	10
OG0005049	0	2	0	8	0	10
OG0005050	0	5	1	3	1	10
OG0005051	0	4	5	1	0	10
OG0005052	0	1	8	1	0	10
OG0005053	0	3	0	7	0	10
OG0005054	0	2	2	5	1	10
OG0005055	0	3	4	3	0	10
OG0005056	0	10	0	0	0	10
OG0005057	0	1	1	3	5	10
OG0005058	0	2	1	5	2	10
OG0005059	0	2	1	6	1	10
OG0005060	0	2	4	3	1	10
OG0005061	0	1	1	7	1	10
OG0005062	0	7	2	1	0	10
OG0005063	0	1	3	5	1	10
OG0005064	0	1	0	9	0	10
OG0005065	0	6	0	4	0	10
OG0005066	0	6	1	2	1	10
OG0005067	0	2	3	3	2	10
OG0005068	0	7	1	1	1	10
OG0005069	0	6	1	2	1	10
OG0005070	0	4	0	6	0	10
OG0005071	0	1	0	9	0	10
OG0005072	0	10	0	0	0	10
OG0005073	0	6	1	3	0	10
OG0005074	0	3	2	4	1	10
OG0005075	0	1	3	2	4	10
OG0005076	0	1	0	9	0	10
OG0005077	0	1	0	7	2	10
OG0005078	0	1	1	8	0	10
OG0005079	0	9	1	0	0	10
OG0005080	0	1	0	9	0	10
OG0005081	0	3	4	3	0	10
OG0005082	0	1	0	9	0	10
OG0005083	0	1	6	1	2	10
OG0005084	0	1	1	7	1	10
OG0005085	0	1	5	1	3	10
OG0005086	0	2	4	3	1	10
OG0005087	0	0	6	3	1	10
OG0005088	0	0	3	0	7	10
OG0005089	0	0	2	8	0	10
OG0005090	0	0	9	1	0	10
OG0005091	0	0	7	2	1	10
OG0005092	0	0	10	0	0	10
OG0005093	0	0	10	0	0	10
OG0005094	0	0	10	0	0	10
OG0005095	0	0	1	1	8	10
OG0005096	0	0	4	6	0	10
OG0005097	0	0	6	0	4	10
OG0005098	0	0	3	7	0	10
OG0005099	0	0	8	0	2	10
OG0005100	0	0	2	8	0	10
OG0005101	0	0	7	3	0	10
OG0005102	0	0	9	0	1	10
OG0005103	0	0	10	0	0	10
OG0005104	0	0	8	2	0	10
OG0005105	0	0	9	0	1	10
OG0005106	0	0	8	0	2	10
OG0005107	0	0	2	6	2	10
OG0005108	0	0	5	4	1	10
OG0005109	0	0	2	3	5	10
OG0005110	0	0	2	7	1	10
OG0005111	0	0	4	1	5	10
OG0005112	0	0	1	0	9	10
OG0005113	0	0	1	9	0	10
OG0005114	0	0	2	7	1	10
OG0005115	0	0	1	3	6	10
OG0005116	0	0	1	9	0	10
OG0005117	0	0	1	9	0	10
OG0005118	0	0	9	1	0	10
OG0005119	0	0	1	9	0	10
OG0005120	0	0	0	10	0	10
OG0005121	0	0	0	10	0	10
OG0005122	0	0	0	10	0	10
OG0005123	0	0	0	10	0	10
OG0005124	0	0	0	10	0	10
OG0005125	0	0	0	10	0	10
OG0005126	0	0	0	10	0	10
OG0005127	0	0	0	10	0	10
OG0005128	0	0	0	10	0	10
OG0005129	0	0	0	10	0	10
OG0005130	0	0	0	6	4	10
OG0005131	0	0	0	10	0	10
OG0005132	0	0	0	10	0	10
OG0005133	0	0	0	10	0	10
OG0005134	0	0	0	10	0	10
OG0005135	0	0	0	10	0	10
OG0005136	0	0	0	10	0	10
OG0005137	0	0	0	10	0	10
OG0005138	0	0	0	10	0	10
OG0005139	4	0	5	0	0	9
OG0005140	1	1	1	6	0	9
OG0005141	2	0	2	1	4	9
OG0005142	4	2	1	2	0	9
OG0005143	2	4	0	3	0	9
OG0005144	1	1	2	4	1	9
OG0005145	1	3	2	2	1	9
OG0005146	2	2	1	3	1	9
OG0005147	1	1	2	4	1	9
OG0005148	2	2	2	1	2	9
OG0005149	2	1	3	2	1	9
OG0005150	1	2	1	4	1	9
OG0005151	2	2	3	2	0	9
OG0005152	1	3	1	3	1	9
OG0005153	3	3	1	1	1	9
OG0005154	1	2	1	4	1	9
OG0005155	3	1	1	3	1	9
OG0005156	3	2	1	2	1	9
OG0005157	2	1	2	4	0	9
OG0005158	3	1	1	3	1	9
OG0005159	3	2	1	2	1	9
OG0005160	1	1	4	2	1	9
OG0005161	1	2	1	4	1	9
OG0005162	1	2	1	4	1	9
OG0005163	1	1	1	5	1	9
OG0005164	2	0	1	2	4	9
OG0005165	1	3	2	2	1	9
OG0005166	1	3	1	3	1	9
OG0005167	1	3	3	2	0	9
OG0005168	1	2	2	4	0	9
OG0005169	2	2	2	2	1	9
OG0005170	2	2	3	1	1	9
OG0005171	1	3	1	3	1	9
OG0005172	1	1	2	4	1	9
OG0005173	2	1	1	4	1	9
OG0005174	1	1	6	0	1	9
OG0005175	1	2	2	3	1	9
OG0005176	2	1	1	4	1	9
OG0005177	1	1	3	3	1	9
OG0005178	1	2	1	5	0	9
OG0005179	9	0	0	0	0	9
OG0005180	2	4	1	1	1	9
OG0005181	3	2	1	1	2	9
OG0005182	2	1	1	4	1	9
OG0005183	1	1	1	4	2	9
OG0005184	8	0	1	0	0	9
OG0005185	8	0	1	0	0	9
OG0005186	2	2	2	2	1	9
OG0005187	1	1	4	3	0	9
OG0005188	1	4	1	3	0	9
OG0005189	2	1	1	4	1	9
OG0005190	2	1	1	5	0	9
OG0005191	6	1	0	2	0	9
OG0005192	2	1	1	4	1	9
OG0005193	2	1	1	5	0	9
OG0005194	1	0	8	0	0	9
OG0005195	1	2	3	3	0	9
OG0005196	1	2	2	4	0	9
OG0005197	1	3	1	3	1	9
OG0005198	2	1	2	3	1	9
OG0005199	2	2	2	2	1	9
OG0005200	1	2	2	3	1	9
OG0005201	2	1	2	3	1	9
OG0005202	1	2	3	2	1	9
OG0005203	2	4	1	1	1	9
OG0005204	2	1	1	4	1	9
OG0005205	2	2	2	1	2	9
OG0005206	2	1	1	5	0	9
OG0005207	1	1	1	5	1	9
OG0005208	2	1	2	3	1	9
OG0005209	1	2	1	4	1	9
OG0005210	1	1	5	1	1	9
OG0005211	2	3	1	2	1	9
OG0005212	1	3	2	3	0	9
OG0005213	2	1	1	4	1	9
OG0005214	2	2	1	4	0	9
OG0005215	2	4	1	1	1	9
OG0005216	2	0	3	3	1	9
OG0005217	1	3	1	3	1	9
OG0005218	4	2	1	1	1	9
OG0005219	1	4	2	1	1	9
OG0005220	4	0	3	0	2	9
OG0005221	2	3	1	2	1	9
OG0005222	1	2	1	4	1	9
OG0005223	1	5	1	2	0	9
OG0005224	1	1	2	3	2	9
OG0005225	1	2	2	3	1	9
OG0005226	1	3	2	2	1	9
OG0005227	1	3	3	1	1	9
OG0005228	1	1	1	6	0	9
OG0005229	3	1	1	3	1	9
OG0005230	2	3	1	3	0	9
OG0005231	2	1	1	4	1	9
OG0005232	1	2	1	4	1	9
OG0005233	1	5	1	1	1	9
OG0005234	1	1	5	1	1	9
OG0005235	5	0	2	2	0	9
OG0005236	1	2	1	4	1	9
OG0005237	2	2	0	4	1	9
OG0005238	1	2	2	4	0	9
OG0005239	2	2	2	2	1	9
OG0005240	1	2	2	4	0	9
OG0005241	1	2	1	4	1	9
OG0005242	4	0	0	5	0	9
OG0005243	2	1	1	4	1	9
OG0005244	1	3	1	3	1	9
OG0005245	1	1	3	3	1	9
OG0005246	1	1	4	2	1	9
OG0005247	1	5	1	1	1	9
OG0005248	3	1	4	1	0	9
OG0005249	1	3	1	4	0	9
OG0005250	1	4	1	2	1	9
OG0005251	3	3	1	1	1	9
OG0005252	1	4	1	2	1	9
OG0005253	1	0	1	7	0	9
OG0005254	1	1	1	5	1	9
OG0005255	1	2	1	5	0	9
OG0005256	2	3	1	3	0	9
OG0005257	1	1	3	4	0	9
OG0005258	1	3	2	2	1	9
OG0005259	1	2	1	4	1	9
OG0005260	1	2	1	5	0	9
OG0005261	2	3	1	2	1	9
OG0005262	3	1	3	1	1	9
OG0005263	1	1	2	3	2	9
OG0005264	2	2	1	3	1	9
OG0005265	3	2	1	3	0	9
OG0005266	1	0	0	8	0	9
OG0005267	1	1	1	6	0	9
OG0005268	3	1	3	1	1	9
OG0005269	9	0	0	0	0	9
OG0005270	3	3	1	2	0	9
OG0005271	1	2	1	5	0	9
OG0005272	1	3	3	1	1	9
OG0005273	5	2	2	0	0	9
OG0005274	1	3	1	3	1	9
OG0005275	1	2	1	4	1	9
OG0005276	1	1	2	4	1	9
OG0005277	2	3	1	1	2	9
OG0005278	1	2	1	4	1	9
OG0005279	1	3	1	3	1	9
OG0005280	1	2	1	4	1	9
OG0005281	1	4	1	2	1	9
OG0005282	1	2	1	4	1	9
OG0005283	1	3	1	3	1	9
OG0005284	1	1	2	3	2	9
OG0005285	3	3	1	1	1	9
OG0005286	2	2	1	4	0	9
OG0005287	3	1	0	5	0	9
OG0005288	3	1	2	3	0	9
OG0005289	1	2	4	1	1	9
OG0005290	1	1	3	2	2	9
OG0005291	2	1	1	4	1	9
OG0005292	2	2	1	3	1	9
OG0005293	2	1	2	4	0	9
OG0005294	1	1	2	1	4	9
OG0005295	1	0	3	4	1	9
OG0005296	3	1	2	3	0	9
OG0005297	2	1	1	4	1	9
OG0005298	2	1	2	4	0	9
OG0005299	1	4	1	1	2	9
OG0005300	4	1	1	2	1	9
OG0005301	2	2	2	2	1	9
OG0005302	1	1	2	4	1	9
OG0005303	1	2	1	4	1	9
OG0005304	1	4	1	1	2	9
OG0005305	3	1	1	3	1	9
OG0005306	1	2	3	3	0	9
OG0005307	1	2	2	2	2	9
OG0005308	2	2	1	3	1	9
OG0005309	2	2	2	3	0	9
OG0005310	2	4	1	1	1	9
OG0005311	1	4	2	1	1	9
OG0005312	2	1	2	3	1	9
OG0005313	2	0	7	0	0	9
OG0005314	1	5	1	2	0	9
OG0005315	3	1	2	2	1	9
OG0005316	2	2	2	2	1	9
OG0005317	3	2	2	1	1	9
OG0005318	1	4	1	3	0	9
OG0005319	1	5	1	1	1	9
OG0005320	2	4	1	1	1	9
OG0005321	1	1	3	3	1	9
OG0005322	1	1	4	2	1	9
OG0005323	1	2	4	2	0	9
OG0005324	1	5	1	2	0	9
OG0005325	1	1	4	2	1	9
OG0005326	1	1	2	4	1	9
OG0005327	1	2	1	5	0	9
OG0005328	1	3	1	4	0	9
OG0005329	1	1	2	5	0	9
OG0005330	1	3	1	3	1	9
OG0005331	3	0	3	3	0	9
OG0005332	4	2	1	1	1	9
OG0005333	2	1	3	3	0	9
OG0005334	2	2	2	3	0	9
OG0005335	1	1	3	3	1	9
OG0005336	2	2	1	3	1	9
OG0005337	1	1	2	4	1	9
OG0005338	1	2	2	3	1	9
OG0005339	1	1	1	5	1	9
OG0005340	3	1	1	3	1	9
OG0005341	1	1	2	4	1	9
OG0005342	2	1	1	4	1	9
OG0005343	2	1	3	2	1	9
OG0005344	4	1	2	1	1	9
OG0005345	1	2	2	3	1	9
OG0005346	2	3	1	2	1	9
OG0005347	1	4	2	1	1	9
OG0005348	1	2	2	4	0	9
OG0005349	1	4	1	3	0	9
OG0005350	1	3	1	3	1	9
OG0005351	1	4	1	2	1	9
OG0005352	2	2	1	4	0	9
OG0005353	1	5	1	2	0	9
OG0005354	1	2	1	4	1	9
OG0005355	1	4	1	2	1	9
OG0005356	6	1	0	1	1	9
OG0005357	1	3	3	2	0	9
OG0005358	2	1	1	4	1	9
OG0005359	4	1	1	2	1	9
OG0005360	2	2	1	4	0	9
OG0005361	1	4	1	2	1	9
OG0005362	4	1	1	2	1	9
OG0005363	1	1	4	2	1	9
OG0005364	1	3	1	2	2	9
OG0005365	2	0	5	0	2	9
OG0005366	1	5	1	1	1	9
OG0005367	1	1	2	4	1	9
OG0005368	1	1	1	5	1	9
OG0005369	2	2	2	2	1	9
OG0005370	3	2	2	2	0	9
OG0005371	1	3	2	3	0	9
OG0005372	5	0	4	0	0	9
OG0005373	1	2	1	5	0	9
OG0005374	5	0	0	0	4	9
OG0005375	1	2	0	5	1	9
OG0005376	1	2	5	1	0	9
OG0005377	1	5	1	1	1	9
OG0005378	2	1	1	4	1	9
OG0005379	3	2	1	3	0	9
OG0005380	1	2	1	4	1	9
OG0005381	1	2	1	5	0	9
OG0005382	1	2	1	4	1	9
OG0005383	4	1	2	1	1	9
OG0005384	1	3	1	4	0	9
OG0005385	1	1	1	5	1	9
OG0005386	1	2	2	4	0	9
OG0005387	2	3	2	1	1	9
OG0005388	1	2	2	4	0	9
OG0005389	1	2	1	4	1	9
OG0005390	2	4	2	1	0	9
OG0005391	3	2	1	2	1	9
OG0005392	1	1	1	5	1	9
OG0005393	1	2	4	1	1	9
OG0005394	1	4	1	2	1	9
OG0005395	2	2	2	2	1	9
OG0005396	1	3	1	2	2	9
OG0005397	1	2	1	4	1	9
OG0005398	2	2	1	3	1	9
OG0005399	2	1	1	4	1	9
OG0005400	1	3	1	3	1	9
OG0005401	2	1	2	4	0	9
OG0005402	1	2	2	3	1	9
OG0005403	1	2	2	4	0	9
OG0005404	2	1	1	4	1	9
OG0005405	2	1	2	4	0	9
OG0005406	2	1	3	2	1	9
OG0005407	3	1	5	0	0	9
OG0005408	1	2	1	4	1	9
OG0005409	1	3	2	2	1	9
OG0005410	1	4	0	3	1	9
OG0005411	1	1	1	6	0	9
OG0005412	1	3	2	3	0	9
OG0005413	3	2	2	1	1	9
OG0005414	2	2	1	3	1	9
OG0005415	2	1	1	4	1	9
OG0005416	1	2	3	2	1	9
OG0005417	2	1	2	3	1	9
OG0005418	1	3	1	3	1	9
OG0005419	3	1	3	1	1	9
OG0005420	2	0	7	0	0	9
OG0005421	1	2	2	3	1	9
OG0005422	4	3	2	0	0	9
OG0005423	1	3	3	1	1	9
OG0005424	8	0	0	1	0	9
OG0005425	1	2	3	2	1	9
OG0005426	2	2	3	1	1	9
OG0005427	6	0	2	0	1	9
OG0005428	3	1	1	3	1	9
OG0005429	1	1	2	3	2	9
OG0005430	3	2	1	2	1	9
OG0005431	1	3	1	3	1	9
OG0005432	2	1	2	3	1	9
OG0005433	1	0	1	7	0	9
OG0005434	1	2	2	2	2	9
OG0005435	1	1	1	5	1	9
OG0005436	1	3	2	1	2	9
OG0005437	1	2	3	3	0	9
OG0005438	3	2	1	3	0	9
OG0005439	2	2	2	2	1	9
OG0005440	1	1	3	3	1	9
OG0005441	1	2	2	4	0	9
OG0005442	2	4	1	1	1	9
OG0005443	2	2	1	3	1	9
OG0005444	1	0	3	5	0	9
OG0005445	1	4	1	2	1	9
OG0005446	1	1	2	4	1	9
OG0005447	1	1	3	3	1	9
OG0005448	2	2	1	3	1	9
OG0005449	4	1	1	3	0	9
OG0005450	2	1	3	2	1	9
OG0005451	1	1	1	5	1	9
OG0005452	1	4	2	2	0	9
OG0005453	1	4	2	1	1	9
OG0005454	2	1	2	4	0	9
OG0005455	2	1	3	3	0	9
OG0005456	1	3	3	2	0	9
OG0005457	1	2	3	2	1	9
OG0005458	1	3	1	4	0	9
OG0005459	9	0	0	0	0	9
OG0005460	2	1	3	2	1	9
OG0005461	1	2	1	5	0	9
OG0005462	1	3	1	4	0	9
OG0005463	1	2	2	3	1	9
OG0005464	1	2	1	4	1	9
OG0005465	2	4	1	2	0	9
OG0005466	2	2	2	1	2	9
OG0005467	1	1	0	7	0	9
OG0005468	2	2	1	4	0	9
OG0005469	4	3	1	1	0	9
OG0005470	3	1	2	2	1	9
OG0005471	2	3	2	2	0	9
OG0005472	1	5	1	2	0	9
OG0005473	1	3	1	3	1	9
OG0005474	3	2	1	2	1	9
OG0005475	1	2	1	4	1	9
OG0005476	2	1	3	3	0	9
OG0005477	1	4	1	2	1	9
OG0005478	1	5	1	1	1	9
OG0005479	1	3	3	1	1	9
OG0005480	1	2	1	4	1	9
OG0005481	2	2	1	4	0	9
OG0005482	2	1	1	4	1	9
OG0005483	1	3	1	3	1	9
OG0005484	1	3	1	3	1	9
OG0005485	3	3	0	3	0	9
OG0005486	2	3	1	3	0	9
OG0005487	1	2	3	2	1	9
OG0005488	2	1	1	5	0	9
OG0005489	1	3	2	3	0	9
OG0005490	2	2	1	3	1	9
OG0005491	1	4	0	4	0	9
OG0005492	2	1	3	1	2	9
OG0005493	1	2	1	4	1	9
OG0005494	1	3	1	3	1	9
OG0005495	1	4	1	3	0	9
OG0005496	1	5	1	1	1	9
OG0005497	9	0	0	0	0	9
OG0005498	3	1	2	2	1	9
OG0005499	1	3	1	3	1	9
OG0005500	1	2	1	2	3	9
OG0005501	9	0	0	0	0	9
OG0005502	8	0	1	0	0	9
OG0005503	2	1	2	3	1	9
OG0005504	1	2	1	3	2	9
OG0005505	3	0	4	1	1	9
OG0005506	1	5	1	2	0	9
OG0005507	1	1	0	7	0	9
OG0005508	3	2	2	2	0	9
OG0005509	3	1	1	2	2	9
OG0005510	1	0	8	0	0	9
OG0005511	3	3	1	1	1	9
OG0005512	9	0	0	0	0	9
OG0005513	2	1	4	2	0	9
OG0005514	1	4	1	2	1	9
OG0005515	5	1	1	2	0	9
OG0005516	1	1	4	2	1	9
OG0005517	1	3	2	2	1	9
OG0005518	1	4	2	2	0	9
OG0005519	3	2	2	1	1	9
OG0005520	1	2	3	2	1	9
OG0005521	8	0	1	0	0	9
OG0005522	2	3	2	1	1	9
OG0005523	2	2	3	1	1	9
OG0005524	2	0	7	0	0	9
OG0005525	2	5	0	2	0	9
OG0005526	1	2	1	5	0	9
OG0005527	2	2	0	5	0	9
OG0005528	4	1	1	2	1	9
OG0005529	2	1	2	2	2	9
OG0005530	2	1	1	5	0	9
OG0005531	1	2	1	4	1	9
OG0005532	1	3	2	2	1	9
OG0005533	1	0	4	4	0	9
OG0005534	3	0	6	0	0	9
OG0005535	3	2	2	1	1	9
OG0005536	2	1	1	3	2	9
OG0005537	3	1	1	3	1	9
OG0005538	2	2	1	4	0	9
OG0005539	1	3	4	1	0	9
OG0005540	1	1	2	4	1	9
OG0005541	3	2	2	2	0	9
OG0005542	1	2	1	4	1	9
OG0005543	1	1	3	2	2	9
OG0005544	1	5	2	1	0	9
OG0005545	1	1	1	6	0	9
OG0005546	1	3	3	1	1	9
OG0005547	1	2	2	3	1	9
OG0005548	1	3	1	2	2	9
OG0005549	2	2	1	3	1	9
OG0005550	1	0	8	0	0	9
OG0005551	1	2	1	4	1	9
OG0005552	1	1	1	5	1	9
OG0005553	1	4	1	2	1	9
OG0005554	1	4	1	2	1	9
OG0005555	1	1	3	3	1	9
OG0005556	1	1	2	5	0	9
OG0005557	1	2	3	1	2	9
OG0005558	1	1	2	3	2	9
OG0005559	3	2	1	3	0	9
OG0005560	1	4	1	2	1	9
OG0005561	1	3	1	3	1	9
OG0005562	1	1	1	5	1	9
OG0005563	2	1	1	4	1	9
OG0005564	6	0	1	2	0	9
OG0005565	1	1	1	4	2	9
OG0005566	1	5	1	1	1	9
OG0005567	2	2	1	4	0	9
OG0005568	1	3	2	2	1	9
OG0005569	3	3	2	1	0	9
OG0005570	1	2	2	3	1	9
OG0005571	2	2	2	2	1	9
OG0005572	1	2	2	3	1	9
OG0005573	2	2	2	2	1	9
OG0005574	1	5	1	1	1	9
OG0005575	2	1	2	3	1	9
OG0005576	2	1	1	3	2	9
OG0005577	1	4	1	2	1	9
OG0005578	2	3	1	2	1	9
OG0005579	1	1	3	3	1	9
OG0005580	2	1	2	3	1	9
OG0005581	2	1	1	4	1	9
OG0005582	1	2	3	2	1	9
OG0005583	0	5	0	4	0	9
OG0005584	0	7	0	2	0	9
OG0005585	0	3	1	5	0	9
OG0005586	0	2	0	7	0	9
OG0005587	0	3	1	5	0	9
OG0005588	0	3	2	3	1	9
OG0005589	0	1	2	5	1	9
OG0005590	0	6	0	3	0	9
OG0005591	0	1	1	5	2	9
OG0005592	0	2	3	3	1	9
OG0005593	0	2	3	2	2	9
OG0005594	0	2	1	6	0	9
OG0005595	0	2	0	7	0	9
OG0005596	0	1	0	8	0	9
OG0005597	0	4	1	3	1	9
OG0005598	0	5	0	4	0	9
OG0005599	0	4	2	2	1	9
OG0005600	0	6	1	1	1	9
OG0005601	0	2	0	6	1	9
OG0005602	0	8	1	0	0	9
OG0005603	0	6	0	2	1	9
OG0005604	0	6	0	3	0	9
OG0005605	0	1	0	8	0	9
OG0005606	0	2	5	2	0	9
OG0005607	0	8	0	1	0	9
OG0005608	0	8	0	1	0	9
OG0005609	0	5	1	2	1	9
OG0005610	0	2	4	2	1	9
OG0005611	0	1	2	6	0	9
OG0005612	0	5	1	2	1	9
OG0005613	0	4	1	1	3	9
OG0005614	0	4	5	0	0	9
OG0005615	0	6	2	1	0	9
OG0005616	0	4	1	3	1	9
OG0005617	0	4	1	4	0	9
OG0005618	0	4	0	5	0	9
OG0005619	0	2	0	7	0	9
OG0005620	0	3	2	4	0	9
OG0005621	0	5	4	0	0	9
OG0005622	0	1	0	8	0	9
OG0005623	0	3	0	5	1	9
OG0005624	0	3	3	3	0	9
OG0005625	0	4	4	1	0	9
OG0005626	0	7	1	1	0	9
OG0005627	0	9	0	0	0	9
OG0005628	0	3	0	6	0	9
OG0005629	0	3	0	6	0	9
OG0005630	0	4	3	2	0	9
OG0005631	0	3	1	5	0	9
OG0005632	0	6	0	3	0	9
OG0005633	0	2	1	5	1	9
OG0005634	0	4	3	1	1	9
OG0005635	0	6	0	3	0	9
OG0005636	0	2	4	3	0	9
OG0005637	0	8	0	0	1	9
OG0005638	0	2	2	4	1	9
OG0005639	0	4	1	2	2	9
OG0005640	0	5	1	1	2	9
OG0005641	0	7	0	2	0	9
OG0005642	0	3	0	4	2	9
OG0005643	0	2	0	7	0	9
OG0005644	0	1	0	8	0	9
OG0005645	0	3	2	4	0	9
OG0005646	0	2	1	6	0	9
OG0005647	0	3	3	2	1	9
OG0005648	0	1	6	1	1	9
OG0005649	0	4	1	3	1	9
OG0005650	0	5	0	4	0	9
OG0005651	0	5	1	2	1	9
OG0005652	0	3	5	1	0	9
OG0005653	0	6	1	2	0	9
OG0005654	0	3	2	4	0	9
OG0005655	0	3	0	6	0	9
OG0005656	0	4	2	2	1	9
OG0005657	0	2	3	3	1	9
OG0005658	0	3	1	4	1	9
OG0005659	0	3	4	1	1	9
OG0005660	0	5	1	3	0	9
OG0005661	0	6	0	3	0	9
OG0005662	0	9	0	0	0	9
OG0005663	0	5	4	0	0	9
OG0005664	0	1	3	4	1	9
OG0005665	0	4	0	0	5	9
OG0005666	0	4	2	2	1	9
OG0005667	0	2	0	7	0	9
OG0005668	0	1	1	7	0	9
OG0005669	0	2	2	3	2	9
OG0005670	0	2	1	6	0	9
OG0005671	0	2	1	6	0	9
OG0005672	0	2	4	2	1	9
OG0005673	0	1	7	0	1	9
OG0005674	0	5	3	1	0	9
OG0005675	0	5	1	3	0	9
OG0005676	0	2	2	3	2	9
OG0005677	0	1	0	8	0	9
OG0005678	0	2	2	4	1	9
OG0005679	0	2	5	2	0	9
OG0005680	0	2	1	4	2	9
OG0005681	0	2	3	3	1	9
OG0005682	0	6	0	2	1	9
OG0005683	0	3	2	3	1	9
OG0005684	0	4	0	5	0	9
OG0005685	0	9	0	0	0	9
OG0005686	0	9	0	0	0	9
OG0005687	0	6	1	2	0	9
OG0005688	0	4	1	4	0	9
OG0005689	0	3	3	2	1	9
OG0005690	0	4	2	2	1	9
OG0005691	0	7	0	2	0	9
OG0005692	0	4	0	3	2	9
OG0005693	0	4	2	1	2	9
OG0005694	0	5	1	2	1	9
OG0005695	0	3	0	6	0	9
OG0005696	0	2	0	7	0	9
OG0005697	0	1	1	6	1	9
OG0005698	0	1	0	8	0	9
OG0005699	0	1	0	8	0	9
OG0005700	0	7	0	2	0	9
OG0005701	0	4	1	2	2	9
OG0005702	0	3	0	6	0	9
OG0005703	0	5	0	3	1	9
OG0005704	0	6	1	2	0	9
OG0005705	0	2	4	3	0	9
OG0005706	0	2	0	7	0	9
OG0005707	0	5	3	1	0	9
OG0005708	0	3	4	2	0	9
OG0005709	0	2	0	7	0	9
OG0005710	0	1	1	6	1	9
OG0005711	0	1	6	2	0	9
OG0005712	0	8	0	1	0	9
OG0005713	0	6	2	1	0	9
OG0005714	0	3	2	3	1	9
OG0005715	0	1	1	7	0	9
OG0005716	0	1	2	2	4	9
OG0005717	0	2	3	3	1	9
OG0005718	0	1	4	4	0	9
OG0005719	0	1	0	8	0	9
OG0005720	0	1	0	8	0	9
OG0005721	0	2	2	4	1	9
OG0005722	0	1	2	5	1	9
OG0005723	0	1	3	3	2	9
OG0005724	0	1	0	8	0	9
OG0005725	0	0	9	0	0	9
OG0005726	0	0	8	0	1	9
OG0005727	0	0	8	0	1	9
OG0005728	0	0	8	1	0	9
OG0005729	0	0	7	1	1	9
OG0005730	0	0	8	0	1	9
OG0005731	0	0	8	1	0	9
OG0005732	0	0	2	2	5	9
OG0005733	0	0	3	5	1	9
OG0005734	0	0	1	0	8	9
OG0005735	0	0	4	2	3	9
OG0005736	0	0	5	2	2	9
OG0005737	0	0	3	6	0	9
OG0005738	0	0	8	0	1	9
OG0005739	0	0	9	0	0	9
OG0005740	0	0	9	0	0	9
OG0005741	0	0	1	8	0	9
OG0005742	0	0	5	0	4	9
OG0005743	0	0	4	0	5	9
OG0005744	0	0	3	6	0	9
OG0005745	0	0	6	2	1	9
OG0005746	0	0	4	2	3	9
OG0005747	0	0	7	2	0	9
OG0005748	0	0	1	5	3	9
OG0005749	0	0	9	0	0	9
OG0005750	0	0	8	1	0	9
OG0005751	0	0	5	4	0	9
OG0005752	0	0	1	8	0	9
OG0005753	0	0	3	0	6	9
OG0005754	0	0	8	0	1	9
OG0005755	0	0	1	6	2	9
OG0005756	0	0	1	8	0	9
OG0005757	0	0	3	4	2	9
OG0005758	0	0	2	5	2	9
OG0005759	0	0	8	1	0	9
OG0005760	0	0	1	8	0	9
OG0005761	0	0	7	1	1	9
OG0005762	0	0	3	1	5	9
OG0005763	0	0	0	8	1	9
OG0005764	0	0	0	9	0	9
OG0005765	0	0	0	9	0	9
OG0005766	0	0	0	9	0	9
OG0005767	0	0	0	9	0	9
OG0005768	0	0	0	9	0	9
OG0005769	0	0	0	9	0	9
OG0005770	0	0	0	9	0	9
OG0005771	0	0	0	9	0	9
OG0005772	0	0	0	9	0	9
OG0005773	0	0	0	9	0	9
OG0005774	0	0	0	9	0	9
OG0005775	0	0	0	9	0	9
OG0005776	0	0	0	9	0	9
OG0005777	0	0	0	9	0	9
OG0005778	0	0	0	9	0	9
OG0005779	0	0	0	0	9	9
OG0005780	0	0	0	0	9	9
OG0005781	2	1	1	4	0	8
OG0005782	1	2	1	3	1	8
OG0005783	1	2	4	1	0	8
OG0005784	1	5	1	1	0	8
OG0005785	1	2	1	3	1	8
OG0005786	2	1	0	5	0	8
OG0005787	1	1	2	4	0	8
OG0005788	4	0	2	0	2	8
OG0005789	3	1	0	3	1	8
OG0005790	4	1	1	2	0	8
OG0005791	1	3	1	2	1	8
OG0005792	2	2	2	1	1	8
OG0005793	1	3	1	2	1	8
OG0005794	2	2	2	1	1	8
OG0005795	1	2	1	3	1	8
OG0005796	1	2	1	4	0	8
OG0005797	1	4	1	2	0	8
OG0005798	1	1	1	5	0	8
OG0005799	8	0	0	0	0	8
OG0005800	1	1	3	2	1	8
OG0005801	1	3	1	2	1	8
OG0005802	1	2	2	2	1	8
OG0005803	2	1	1	3	1	8
OG0005804	4	1	1	1	1	8
OG0005805	1	1	1	4	1	8
OG0005806	1	2	1	4	0	8
OG0005807	1	1	2	3	1	8
OG0005808	1	2	1	3	1	8
OG0005809	1	1	2	3	1	8
OG0005810	2	1	2	2	1	8
OG0005811	1	2	2	1	2	8
OG0005812	2	2	1	2	1	8
OG0005813	1	1	1	3	2	8
OG0005814	1	1	1	4	1	8
OG0005815	1	4	1	1	1	8
OG0005816	1	1	1	4	1	8
OG0005817	5	0	3	0	0	8
OG0005818	1	2	2	2	1	8
OG0005819	1	1	1	4	1	8
OG0005820	3	0	2	2	1	8
OG0005821	1	3	1	3	0	8
OG0005822	1	3	2	1	1	8
OG0005823	1	2	1	3	1	8
OG0005824	1	1	1	4	1	8
OG0005825	1	2	1	4	0	8
OG0005826	1	2	1	4	0	8
OG0005827	1	3	1	1	2	8
OG0005828	1	1	1	4	1	8
OG0005829	3	1	1	3	0	8
OG0005830	2	3	1	2	0	8
OG0005831	4	2	1	1	0	8
OG0005832	1	1	3	2	1	8
OG0005833	1	1	1	5	0	8
OG0005834	1	1	1	4	1	8
OG0005835	1	1	1	4	1	8
OG0005836	1	3	1	3	0	8
OG0005837	4	0	4	0	0	8
OG0005838	1	1	1	3	2	8
OG0005839	1	1	1	4	1	8
OG0005840	1	3	1	2	1	8
OG0005841	1	2	2	2	1	8
OG0005842	1	3	2	1	1	8
OG0005843	3	0	5	0	0	8
OG0005844	1	0	2	4	1	8
OG0005845	1	1	2	4	0	8
OG0005846	3	2	1	1	1	8
OG0005847	1	2	1	3	1	8
OG0005848	1	1	1	4	1	8
OG0005849	1	4	1	2	0	8
OG0005850	3	2	1	2	0	8
OG0005851	1	2	2	2	1	8
OG0005852	1	2	2	2	1	8
OG0005853	1	2	2	3	0	8
OG0005854	1	4	1	2	0	8
OG0005855	8	0	0	0	0	8
OG0005856	2	1	2	2	1	8
OG0005857	7	0	1	0	0	8
OG0005858	4	2	1	1	0	8
OG0005859	1	3	1	2	1	8
OG0005860	2	2	1	3	0	8
OG0005861	1	1	1	4	1	8
OG0005862	1	1	2	3	1	8
OG0005863	2	2	1	2	1	8
OG0005864	2	2	2	1	1	8
OG0005865	3	1	2	2	0	8
OG0005866	2	1	1	2	2	8
OG0005867	1	2	1	3	1	8
OG0005868	1	3	1	3	0	8
OG0005869	1	4	1	2	0	8
OG0005870	8	0	0	0	0	8
OG0005871	1	1	1	5	0	8
OG0005872	2	4	1	0	1	8
OG0005873	1	3	2	2	0	8
OG0005874	1	1	2	3	1	8
OG0005875	1	4	2	1	0	8
OG0005876	2	1	2	2	1	8
OG0005877	1	2	1	3	1	8
OG0005878	1	2	1	3	1	8
OG0005879	2	1	3	2	0	8
OG0005880	3	1	1	2	1	8
OG0005881	5	0	3	0	0	8
OG0005882	1	1	3	2	1	8
OG0005883	1	4	1	2	0	8
OG0005884	2	0	1	5	0	8
OG0005885	1	1	2	3	1	8
OG0005886	3	1	1	2	1	8
OG0005887	1	1	1	4	1	8
OG0005888	1	2	4	1	0	8
OG0005889	1	2	1	3	1	8
OG0005890	1	3	1	2	1	8
OG0005891	2	2	1	1	2	8
OG0005892	2	3	1	2	0	8
OG0005893	1	2	1	3	1	8
OG0005894	1	0	3	4	0	8
OG0005895	1	1	2	3	1	8
OG0005896	1	1	2	3	1	8
OG0005897	1	2	2	2	1	8
OG0005898	1	1	1	3	2	8
OG0005899	1	1	1	4	1	8
OG0005900	1	1	2	3	1	8
OG0005901	1	2	1	2	2	8
OG0005902	1	1	2	3	1	8
OG0005903	2	1	1	3	1	8
OG0005904	1	3	1	2	1	8
OG0005905	3	2	1	1	1	8
OG0005906	4	0	2	0	2	8
OG0005907	2	2	1	2	1	8
OG0005908	1	3	1	1	2	8
OG0005909	2	1	2	2	1	8
OG0005910	1	2	1	4	0	8
OG0005911	2	1	3	2	0	8
OG0005912	1	1	1	4	1	8
OG0005913	4	0	3	1	0	8
OG0005914	1	1	1	4	1	8
OG0005915	3	1	1	2	1	8
OG0005916	1	2	2	1	2	8
OG0005917	2	3	1	1	1	8
OG0005918	1	2	1	4	0	8
OG0005919	2	1	4	0	1	8
OG0005920	2	2	2	2	0	8
OG0005921	1	3	2	1	1	8
OG0005922	1	3	1	2	1	8
OG0005923	1	0	0	7	0	8
OG0005924	1	0	7	0	0	8
OG0005925	1	2	2	2	1	8
OG0005926	1	1	2	2	2	8
OG0005927	2	1	4	1	0	8
OG0005928	1	2	2	2	1	8
OG0005929	1	2	2	2	1	8
OG0005930	2	1	1	3	1	8
OG0005931	1	3	1	1	2	8
OG0005932	1	2	2	2	1	8
OG0005933	1	1	2	3	1	8
OG0005934	1	1	1	4	1	8
OG0005935	4	1	1	1	1	8
OG0005936	2	1	1	2	2	8
OG0005937	2	1	2	3	0	8
OG0005938	1	1	1	4	1	8
OG0005939	1	2	1	4	0	8
OG0005940	1	1	2	3	1	8
OG0005941	1	1	1	4	1	8
OG0005942	2	3	1	1	1	8
OG0005943	1	4	1	1	1	8
OG0005944	2	1	2	3	0	8
OG0005945	1	2	2	2	1	8
OG0005946	3	2	1	1	1	8
OG0005947	1	3	2	1	1	8
OG0005948	2	4	1	1	0	8
OG0005949	1	4	1	1	1	8
OG0005950	1	2	2	2	1	8
OG0005951	1	1	2	4	0	8
OG0005952	1	2	2	2	1	8
OG0005953	1	3	1	3	0	8
OG0005954	1	1	1	4	1	8
OG0005955	3	1	3	1	0	8
OG0005956	1	1	1	4	1	8
OG0005957	1	1	1	4	1	8
OG0005958	1	2	1	2	2	8
OG0005959	1	2	2	2	1	8
OG0005960	1	3	1	2	1	8
OG0005961	1	2	1	3	1	8
OG0005962	1	0	1	6	0	8
OG0005963	1	1	1	5	0	8
OG0005964	1	1	4	1	1	8
OG0005965	1	1	3	3	0	8
OG0005966	2	2	1	2	1	8
OG0005967	1	1	1	4	1	8
OG0005968	2	4	1	1	0	8
OG0005969	4	0	2	2	0	8
OG0005970	1	3	0	3	1	8
OG0005971	3	1	2	1	1	8
OG0005972	1	1	1	4	1	8
OG0005973	1	1	2	3	1	8
OG0005974	2	3	1	1	1	8
OG0005975	3	0	5	0	0	8
OG0005976	1	4	1	1	1	8
OG0005977	2	2	1	2	1	8
OG0005978	6	0	2	0	0	8
OG0005979	4	1	1	2	0	8
OG0005980	4	1	2	1	0	8
OG0005981	8	0	0	0	0	8
OG0005982	1	3	3	1	0	8
OG0005983	1	2	2	1	2	8
OG0005984	1	3	2	1	1	8
OG0005985	1	0	1	5	1	8
OG0005986	2	1	1	2	2	8
OG0005987	1	1	4	2	0	8
OG0005988	1	4	2	1	0	8
OG0005989	2	1	2	2	1	8
OG0005990	1	2	1	4	0	8
OG0005991	2	2	2	1	1	8
OG0005992	1	1	1	4	1	8
OG0005993	7	0	1	0	0	8
OG0005994	7	0	1	0	0	8
OG0005995	1	1	1	4	1	8
OG0005996	3	1	1	2	1	8
OG0005997	2	1	1	2	2	8
OG0005998	2	1	1	3	1	8
OG0005999	8	0	0	0	0	8
OG0006000	2	1	1	3	1	8
OG0006001	1	1	1	4	1	8
OG0006002	1	1	1	4	1	8
OG0006003	1	3	1	2	1	8
OG0006004	2	2	1	2	1	8
OG0006005	2	0	6	0	0	8
OG0006006	2	1	1	3	1	8
OG0006007	1	1	2	3	1	8
OG0006008	1	1	1	4	1	8
OG0006009	1	1	1	3	2	8
OG0006010	2	0	6	0	0	8
OG0006011	3	1	2	1	1	8
OG0006012	8	0	0	0	0	8
OG0006013	3	1	1	2	1	8
OG0006014	2	1	1	3	1	8
OG0006015	3	1	2	2	0	8
OG0006016	1	1	1	4	1	8
OG0006017	2	2	2	2	0	8
OG0006018	2	1	2	2	1	8
OG0006019	1	1	1	4	1	8
OG0006020	1	3	1	2	1	8
OG0006021	2	2	1	2	1	8
OG0006022	1	1	1	4	1	8
OG0006023	3	0	4	1	0	8
OG0006024	5	0	3	0	0	8
OG0006025	5	1	0	2	0	8
OG0006026	8	0	0	0	0	8
OG0006027	1	1	2	3	1	8
OG0006028	1	1	1	4	1	8
OG0006029	2	1	1	4	0	8
OG0006030	1	1	4	2	0	8
OG0006031	2	2	1	3	0	8
OG0006032	1	1	3	2	1	8
OG0006033	1	3	1	2	1	8
OG0006034	2	2	1	1	2	8
OG0006035	3	0	5	0	0	8
OG0006036	1	2	2	3	0	8
OG0006037	4	2	1	1	0	8
OG0006038	1	0	2	5	0	8
OG0006039	1	4	1	1	1	8
OG0006040	1	2	2	3	0	8
OG0006041	3	1	1	1	2	8
OG0006042	4	2	1	1	0	8
OG0006043	1	2	2	2	1	8
OG0006044	8	0	0	0	0	8
OG0006045	4	0	4	0	0	8
OG0006046	2	0	5	0	1	8
OG0006047	1	4	1	1	1	8
OG0006048	1	1	1	4	1	8
OG0006049	1	1	3	3	0	8
OG0006050	1	1	2	3	1	8
OG0006051	1	4	1	1	1	8
OG0006052	1	2	2	2	1	8
OG0006053	1	1	1	4	1	8
OG0006054	2	1	4	1	0	8
OG0006055	1	1	2	2	2	8
OG0006056	1	3	1	1	2	8
OG0006057	1	2	3	1	1	8
OG0006058	1	1	4	2	0	8
OG0006059	1	3	1	1	2	8
OG0006060	1	2	1	3	1	8
OG0006061	1	1	1	4	1	8
OG0006062	1	2	1	3	1	8
OG0006063	1	3	2	2	0	8
OG0006064	1	1	1	4	1	8
OG0006065	7	0	1	0	0	8
OG0006066	1	1	1	4	1	8
OG0006067	1	3	1	2	1	8
OG0006068	1	3	1	2	1	8
OG0006069	2	1	3	2	0	8
OG0006070	1	1	3	2	1	8
OG0006071	2	1	3	2	0	8
OG0006072	1	2	2	2	1	8
OG0006073	2	1	1	3	1	8
OG0006074	1	2	1	3	1	8
OG0006075	3	2	1	2	0	8
OG0006076	1	2	1	4	0	8
OG0006077	1	1	1	3	2	8
OG0006078	2	1	4	1	0	8
OG0006079	1	1	1	4	1	8
OG0006080	3	1	1	3	0	8
OG0006081	2	2	1	2	1	8
OG0006082	1	1	1	5	0	8
OG0006083	8	0	0	0	0	8
OG0006084	1	2	2	2	1	8
OG0006085	1	4	1	1	1	8
OG0006086	2	1	3	1	1	8
OG0006087	1	2	1	3	1	8
OG0006088	1	1	1	3	2	8
OG0006089	1	2	3	1	1	8
OG0006090	2	2	1	2	1	8
OG0006091	1	2	1	3	1	8
OG0006092	3	2	0	2	1	8
OG0006093	1	2	2	3	0	8
OG0006094	1	4	1	1	1	8
OG0006095	1	2	1	2	2	8
OG0006096	1	3	1	3	0	8
OG0006097	1	2	2	2	1	8
OG0006098	1	2	1	3	1	8
OG0006099	1	2	2	2	1	8
OG0006100	2	0	4	1	1	8
OG0006101	2	2	1	2	1	8
OG0006102	1	2	2	2	1	8
OG0006103	1	2	2	3	0	8
OG0006104	1	2	2	2	1	8
OG0006105	1	0	1	3	3	8
OG0006106	2	0	4	1	1	8
OG0006107	1	4	1	1	1	8
OG0006108	2	1	2	2	1	8
OG0006109	3	1	1	2	1	8
OG0006110	1	2	0	4	1	8
OG0006111	1	2	1	3	1	8
OG0006112	1	1	2	4	0	8
OG0006113	1	3	2	2	0	8
OG0006114	3	1	3	1	0	8
OG0006115	3	1	1	1	2	8
OG0006116	1	2	1	2	2	8
OG0006117	1	1	3	3	0	8
OG0006118	1	2	1	2	2	8
OG0006119	1	3	2	1	1	8
OG0006120	2	1	4	1	0	8
OG0006121	1	3	1	2	1	8
OG0006122	1	2	2	2	1	8
OG0006123	2	2	1	1	2	8
OG0006124	2	4	1	0	1	8
OG0006125	1	2	1	3	1	8
OG0006126	1	2	1	2	2	8
OG0006127	2	1	1	3	1	8
OG0006128	2	2	1	3	0	8
OG0006129	3	0	0	0	5	8
OG0006130	1	1	1	4	1	8
OG0006131	1	1	1	4	1	8
OG0006132	1	1	1	2	3	8
OG0006133	1	2	1	3	1	8
OG0006134	2	1	3	2	0	8
OG0006135	3	1	1	1	2	8
OG0006136	1	3	0	4	0	8
OG0006137	2	2	1	2	1	8
OG0006138	1	1	1	5	0	8
OG0006139	1	1	1	4	1	8
OG0006140	1	3	2	1	1	8
OG0006141	1	3	1	2	1	8
OG0006142	2	0	1	4	1	8
OG0006143	2	1	1	3	1	8
OG0006144	1	3	1	2	1	8
OG0006145	2	1	2	2	1	8
OG0006146	1	2	1	3	1	8
OG0006147	1	4	1	1	1	8
OG0006148	3	1	2	1	1	8
OG0006149	1	1	2	3	1	8
OG0006150	1	3	2	1	1	8
OG0006151	1	2	1	4	0	8
OG0006152	1	2	1	3	1	8
OG0006153	2	1	3	1	1	8
OG0006154	1	1	2	2	2	8
OG0006155	2	0	6	0	0	8
OG0006156	3	2	1	1	1	8
OG0006157	2	2	1	3	0	8
OG0006158	2	1	1	3	1	8
OG0006159	2	3	1	0	2	8
OG0006160	1	1	1	4	1	8
OG0006161	1	1	1	4	1	8
OG0006162	1	0	7	0	0	8
OG0006163	3	3	0	2	0	8
OG0006164	2	1	1	3	1	8
OG0006165	3	1	1	3	0	8
OG0006166	1	2	1	4	0	8
OG0006167	1	5	0	2	0	8
OG0006168	1	1	1	4	1	8
OG0006169	2	1	1	3	1	8
OG0006170	1	2	3	1	1	8
OG0006171	3	1	1	2	1	8
OG0006172	1	1	3	3	0	8
OG0006173	1	1	1	4	1	8
OG0006174	1	2	1	3	1	8
OG0006175	1	1	4	1	1	8
OG0006176	1	0	1	5	1	8
OG0006177	1	3	2	2	0	8
OG0006178	2	1	1	3	1	8
OG0006179	2	2	2	1	1	8
OG0006180	1	1	1	3	2	8
OG0006181	2	1	2	3	0	8
OG0006182	3	2	1	1	1	8
OG0006183	2	3	1	2	0	8
OG0006184	1	3	1	2	1	8
OG0006185	3	0	3	0	2	8
OG0006186	1	2	1	3	1	8
OG0006187	4	1	1	1	1	8
OG0006188	2	0	4	2	0	8
OG0006189	1	1	3	2	1	8
OG0006190	2	2	2	1	1	8
OG0006191	1	2	2	2	1	8
OG0006192	1	0	4	2	1	8
OG0006193	1	2	1	4	0	8
OG0006194	1	0	4	3	0	8
OG0006195	1	2	2	2	1	8
OG0006196	3	0	5	0	0	8
OG0006197	2	0	2	4	0	8
OG0006198	1	1	2	3	1	8
OG0006199	1	0	4	0	3	8
OG0006200	2	2	1	2	1	8
OG0006201	1	1	3	3	0	8
OG0006202	2	2	1	2	1	8
OG0006203	1	2	2	3	0	8
OG0006204	3	1	1	3	0	8
OG0006205	2	1	2	3	0	8
OG0006206	3	1	2	1	1	8
OG0006207	1	1	2	4	0	8
OG0006208	2	2	1	2	1	8
OG0006209	3	2	1	2	0	8
OG0006210	2	1	2	2	1	8
OG0006211	1	2	0	5	0	8
OG0006212	2	1	1	3	1	8
OG0006213	1	3	1	3	0	8
OG0006214	2	5	0	1	0	8
OG0006215	1	2	1	3	1	8
OG0006216	2	1	1	4	0	8
OG0006217	1	3	1	2	1	8
OG0006218	1	0	5	2	0	8
OG0006219	1	6	1	0	0	8
OG0006220	1	2	1	2	2	8
OG0006221	1	1	2	3	1	8
OG0006222	1	1	4	1	1	8
OG0006223	1	3	1	2	1	8
OG0006224	3	1	1	2	1	8
OG0006225	3	1	1	2	1	8
OG0006226	1	4	1	2	0	8
OG0006227	1	2	1	3	1	8
OG0006228	1	3	1	2	1	8
OG0006229	3	2	1	2	0	8
OG0006230	1	2	2	2	1	8
OG0006231	2	1	2	2	1	8
OG0006232	1	1	3	2	1	8
OG0006233	1	2	1	4	0	8
OG0006234	1	1	3	2	1	8
OG0006235	2	1	1	3	1	8
OG0006236	1	3	0	3	1	8
OG0006237	2	2	1	2	1	8
OG0006238	2	1	2	2	1	8
OG0006239	2	1	2	2	1	8
OG0006240	0	3	4	1	0	8
OG0006241	0	4	0	4	0	8
OG0006242	0	2	2	2	2	8
OG0006243	0	2	0	5	1	8
OG0006244	0	2	0	6	0	8
OG0006245	0	5	2	1	0	8
OG0006246	0	7	0	0	1	8
OG0006247	0	1	2	5	0	8
OG0006248	0	2	0	6	0	8
OG0006249	0	4	2	2	0	8
OG0006250	0	1	2	4	1	8
OG0006251	0	4	2	1	1	8
OG0006252	0	1	0	7	0	8
OG0006253	0	2	0	5	1	8
OG0006254	0	5	1	2	0	8
OG0006255	0	1	2	5	0	8
OG0006256	0	2	1	5	0	8
OG0006257	0	3	2	2	1	8
OG0006258	0	2	0	5	1	8
OG0006259	0	1	6	1	0	8
OG0006260	0	1	0	6	1	8
OG0006261	0	1	0	7	0	8
OG0006262	0	3	1	4	0	8
OG0006263	0	6	0	2	0	8
OG0006264	0	7	1	0	0	8
OG0006265	0	1	7	0	0	8
OG0006266	0	3	3	1	1	8
OG0006267	0	1	4	3	0	8
OG0006268	0	2	0	6	0	8
OG0006269	0	2	1	4	1	8
OG0006270	0	2	0	6	0	8
OG0006271	0	4	4	0	0	8
OG0006272	0	4	0	4	0	8
OG0006273	0	3	0	5	0	8
OG0006274	0	2	1	5	0	8
OG0006275	0	4	0	4	0	8
OG0006276	0	2	0	6	0	8
OG0006277	0	3	0	5	0	8
OG0006278	0	2	1	5	0	8
OG0006279	0	3	2	3	0	8
OG0006280	0	4	2	1	1	8
OG0006281	0	8	0	0	0	8
OG0006282	0	4	0	4	0	8
OG0006283	0	3	2	3	0	8
OG0006284	0	1	1	6	0	8
OG0006285	0	3	3	2	0	8
OG0006286	0	3	0	5	0	8
OG0006287	0	3	1	2	2	8
OG0006288	0	4	2	1	1	8
OG0006289	0	2	3	3	0	8
OG0006290	0	2	2	4	0	8
OG0006291	0	1	2	5	0	8
OG0006292	0	6	0	2	0	8
OG0006293	0	2	0	6	0	8
OG0006294	0	1	1	5	1	8
OG0006295	0	2	0	6	0	8
OG0006296	0	4	1	2	1	8
OG0006297	0	2	1	5	0	8
OG0006298	0	2	1	5	0	8
OG0006299	0	1	0	7	0	8
OG0006300	0	2	6	0	0	8
OG0006301	0	2	0	6	0	8
OG0006302	0	4	0	4	0	8
OG0006303	0	2	0	6	0	8
OG0006304	0	2	0	6	0	8
OG0006305	0	2	1	5	0	8
OG0006306	0	1	2	4	1	8
OG0006307	0	6	0	2	0	8
OG0006308	0	2	0	6	0	8
OG0006309	0	3	0	5	0	8
OG0006310	0	2	2	4	0	8
OG0006311	0	1	2	4	1	8
OG0006312	0	2	0	6	0	8
OG0006313	0	3	1	3	1	8
OG0006314	0	5	2	1	0	8
OG0006315	0	4	0	4	0	8
OG0006316	0	7	0	1	0	8
OG0006317	0	2	1	4	1	8
OG0006318	0	2	3	2	1	8
OG0006319	0	8	0	0	0	8
OG0006320	0	2	1	4	1	8
OG0006321	0	8	0	0	0	8
OG0006322	0	3	1	4	0	8
OG0006323	0	2	0	6	0	8
OG0006324	0	1	5	2	0	8
OG0006325	0	2	4	1	1	8
OG0006326	0	1	1	6	0	8
OG0006327	0	7	0	1	0	8
OG0006328	0	8	0	0	0	8
OG0006329	0	2	1	5	0	8
OG0006330	0	3	0	5	0	8
OG0006331	0	3	0	5	0	8
OG0006332	0	2	2	3	1	8
OG0006333	0	2	0	6	0	8
OG0006334	0	1	2	5	0	8
OG0006335	0	1	0	7	0	8
OG0006336	0	4	0	4	0	8
OG0006337	0	4	0	4	0	8
OG0006338	0	8	0	0	0	8
OG0006339	0	2	0	5	1	8
OG0006340	0	7	1	0	0	8
OG0006341	0	3	0	5	0	8
OG0006342	0	1	1	5	1	8
OG0006343	0	3	0	5	0	8
OG0006344	0	5	1	1	1	8
OG0006345	0	3	1	3	1	8
OG0006346	0	7	0	1	0	8
OG0006347	0	5	1	2	0	8
OG0006348	0	8	0	0	0	8
OG0006349	0	4	0	4	0	8
OG0006350	0	6	2	0	0	8
OG0006351	0	5	2	1	0	8
OG0006352	0	4	0	4	0	8
OG0006353	0	1	0	7	0	8
OG0006354	0	2	1	4	1	8
OG0006355	0	4	1	2	1	8
OG0006356	0	4	1	2	1	8
OG0006357	0	8	0	0	0	8
OG0006358	0	6	0	1	1	8
OG0006359	0	2	0	5	1	8
OG0006360	0	2	0	6	0	8
OG0006361	0	2	0	6	0	8
OG0006362	0	3	0	5	0	8
OG0006363	0	4	1	2	1	8
OG0006364	0	5	0	3	0	8
OG0006365	0	2	1	5	0	8
OG0006366	0	2	2	2	2	8
OG0006367	0	3	0	4	1	8
OG0006368	0	6	0	2	0	8
OG0006369	0	8	0	0	0	8
OG0006370	0	3	1	3	1	8
OG0006371	0	3	2	2	1	8
OG0006372	0	6	0	2	0	8
OG0006373	0	8	0	0	0	8
OG0006374	0	1	4	2	1	8
OG0006375	0	5	1	2	0	8
OG0006376	0	2	0	6	0	8
OG0006377	0	5	1	2	0	8
OG0006378	0	4	2	1	1	8
OG0006379	0	6	2	0	0	8
OG0006380	0	2	1	3	2	8
OG0006381	0	8	0	0	0	8
OG0006382	0	3	5	0	0	8
OG0006383	0	5	1	1	1	8
OG0006384	0	3	0	5	0	8
OG0006385	0	3	2	2	1	8
OG0006386	0	6	1	1	0	8
OG0006387	0	1	1	4	2	8
OG0006388	0	6	0	2	0	8
OG0006389	0	2	5	1	0	8
OG0006390	0	5	0	3	0	8
OG0006391	0	6	0	2	0	8
OG0006392	0	5	1	2	0	8
OG0006393	0	2	0	6	0	8
OG0006394	0	8	0	0	0	8
OG0006395	0	2	0	6	0	8
OG0006396	0	7	0	1	0	8
OG0006397	0	5	1	2	0	8
OG0006398	0	3	2	2	1	8
OG0006399	0	5	1	1	1	8
OG0006400	0	3	3	2	0	8
OG0006401	0	3	2	2	1	8
OG0006402	0	4	1	1	2	8
OG0006403	0	3	0	5	0	8
OG0006404	0	2	6	0	0	8
OG0006405	0	2	4	1	1	8
OG0006406	0	2	1	4	1	8
OG0006407	0	8	0	0	0	8
OG0006408	0	3	2	3	0	8
OG0006409	0	6	1	1	0	8
OG0006410	0	4	0	4	0	8
OG0006411	0	3	3	1	1	8
OG0006412	0	3	3	2	0	8
OG0006413	0	4	1	2	1	8
OG0006414	0	6	0	1	1	8
OG0006415	0	1	5	2	0	8
OG0006416	0	4	0	4	0	8
OG0006417	0	4	0	1	3	8
OG0006418	0	5	0	3	0	8
OG0006419	0	3	4	1	0	8
OG0006420	0	1	0	7	0	8
OG0006421	0	3	0	5	0	8
OG0006422	0	7	0	1	0	8
OG0006423	0	3	0	5	0	8
OG0006424	0	1	2	2	3	8
OG0006425	0	1	3	4	0	8
OG0006426	0	2	2	2	2	8
OG0006427	0	5	0	3	0	8
OG0006428	0	1	1	6	0	8
OG0006429	0	2	2	3	1	8
OG0006430	0	1	0	7	0	8
OG0006431	0	4	0	4	0	8
OG0006432	0	1	0	7	0	8
OG0006433	0	1	3	3	1	8
OG0006434	0	4	0	4	0	8
OG0006435	0	2	3	1	2	8
OG0006436	0	1	3	3	1	8
OG0006437	0	1	1	3	3	8
OG0006438	0	3	0	5	0	8
OG0006439	0	2	0	6	0	8
OG0006440	0	6	1	1	0	8
OG0006441	0	1	2	4	1	8
OG0006442	0	1	1	6	0	8
OG0006443	0	1	4	2	1	8
OG0006444	0	1	1	6	0	8
OG0006445	0	1	3	4	0	8
OG0006446	0	1	1	5	1	8
OG0006447	0	3	3	2	0	8
OG0006448	0	1	2	4	1	8
OG0006449	0	1	4	2	1	8
OG0006450	0	1	4	2	1	8
OG0006451	0	1	3	4	0	8
OG0006452	0	1	1	5	1	8
OG0006453	0	1	1	4	2	8
OG0006454	0	1	0	7	0	8
OG0006455	0	1	1	6	0	8
OG0006456	0	1	0	7	0	8
OG0006457	0	0	8	0	0	8
OG0006458	0	0	7	0	1	8
OG0006459	0	0	7	1	0	8
OG0006460	0	0	8	0	0	8
OG0006461	0	0	6	0	2	8
OG0006462	0	0	3	5	0	8
OG0006463	0	0	3	0	5	8
OG0006464	0	0	4	3	1	8
OG0006465	0	0	5	1	2	8
OG0006466	0	0	4	4	0	8
OG0006467	0	0	5	0	3	8
OG0006468	0	0	1	7	0	8
OG0006469	0	0	7	0	1	8
OG0006470	0	0	7	1	0	8
OG0006471	0	0	8	0	0	8
OG0006472	0	0	6	0	2	8
OG0006473	0	0	8	0	0	8
OG0006474	0	0	8	0	0	8
OG0006475	0	0	1	0	7	8
OG0006476	0	0	8	0	0	8
OG0006477	0	0	7	1	0	8
OG0006478	0	0	2	6	0	8
OG0006479	0	0	2	0	6	8
OG0006480	0	0	3	5	0	8
OG0006481	0	0	8	0	0	8
OG0006482	0	0	6	0	2	8
OG0006483	0	0	8	0	0	8
OG0006484	0	0	3	3	2	8
OG0006485	0	0	8	0	0	8
OG0006486	0	0	1	6	1	8
OG0006487	0	0	2	0	6	8
OG0006488	0	0	4	3	1	8
OG0006489	0	0	4	4	0	8
OG0006490	0	0	7	1	0	8
OG0006491	0	0	4	4	0	8
OG0006492	0	0	4	0	4	8
OG0006493	0	0	7	0	1	8
OG0006494	0	0	4	3	1	8
OG0006495	0	0	1	7	0	8
OG0006496	0	0	7	1	0	8
OG0006497	0	0	1	7	0	8
OG0006498	0	0	1	7	0	8
OG0006499	0	0	7	1	0	8
OG0006500	0	0	8	0	0	8
OG0006501	0	0	2	6	0	8
OG0006502	0	0	6	0	2	8
OG0006503	0	0	7	0	1	8
OG0006504	0	0	8	0	0	8
OG0006505	0	0	2	5	1	8
OG0006506	0	0	5	3	0	8
OG0006507	0	0	1	7	0	8
OG0006508	0	0	1	7	0	8
OG0006509	0	0	7	1	0	8
OG0006510	0	0	2	6	0	8
OG0006511	0	0	1	5	2	8
OG0006512	0	0	1	6	1	8
OG0006513	0	0	2	6	0	8
OG0006514	0	0	4	4	0	8
OG0006515	0	0	7	1	0	8
OG0006516	0	0	1	7	0	8
OG0006517	0	0	0	8	0	8
OG0006518	0	0	0	8	0	8
OG0006519	0	0	0	7	1	8
OG0006520	0	0	0	8	0	8
OG0006521	0	0	0	8	0	8
OG0006522	0	0	0	8	0	8
OG0006523	0	0	0	7	1	8
OG0006524	0	0	0	7	1	8
OG0006525	0	0	0	8	0	8
OG0006526	0	0	0	8	0	8
OG0006527	0	0	0	7	1	8
OG0006528	0	0	0	8	0	8
OG0006529	0	0	0	8	0	8
OG0006530	0	0	0	8	0	8
OG0006531	0	0	0	8	0	8
OG0006532	0	0	0	8	0	8
OG0006533	0	0	0	8	0	8
OG0006534	0	0	0	8	0	8
OG0006535	0	0	0	8	0	8
OG0006536	0	0	0	8	0	8
OG0006537	0	0	0	8	0	8
OG0006538	0	0	0	8	0	8
OG0006539	0	0	0	6	2	8
OG0006540	0	0	0	8	0	8
OG0006541	0	0	0	8	0	8
OG0006542	0	0	0	0	8	8
OG0006543	1	3	1	1	1	7
OG0006544	1	2	1	2	1	7
OG0006545	1	1	0	4	1	7
OG0006546	2	1	1	3	0	7
OG0006547	1	2	2	1	1	7
OG0006548	1	2	1	2	1	7
OG0006549	1	3	1	2	0	7
OG0006550	1	2	0	3	1	7
OG0006551	2	2	2	1	0	7
OG0006552	2	1	1	2	1	7
OG0006553	1	1	1	4	0	7
OG0006554	1	2	2	2	0	7
OG0006555	3	0	1	2	1	7
OG0006556	1	1	1	3	1	7
OG0006557	1	2	1	2	1	7
OG0006558	1	2	1	3	0	7
OG0006559	1	2	1	2	1	7
OG0006560	3	2	1	1	0	7
OG0006561	1	3	1	1	1	7
OG0006562	1	1	3	1	1	7
OG0006563	1	3	1	1	1	7
OG0006564	6	0	1	0	0	7
OG0006565	1	2	1	2	1	7
OG0006566	1	3	1	1	1	7
OG0006567	3	1	1	1	1	7
OG0006568	2	1	2	2	0	7
OG0006569	2	1	1	2	1	7
OG0006570	1	1	2	1	2	7
OG0006571	1	1	2	3	0	7
OG0006572	1	1	1	3	1	7
OG0006573	1	2	2	1	1	7
OG0006574	2	1	1	2	1	7
OG0006575	1	1	1	4	0	7
OG0006576	2	2	1	1	1	7
OG0006577	3	1	1	1	1	7
OG0006578	1	1	1	4	0	7
OG0006579	1	2	1	3	0	7
OG0006580	2	1	2	2	0	7
OG0006581	1	1	3	1	1	7
OG0006582	4	0	2	1	0	7
OG0006583	1	2	1	2	1	7
OG0006584	2	3	1	1	0	7
OG0006585	5	0	2	0	0	7
OG0006586	1	2	1	2	1	7
OG0006587	1	1	1	3	1	7
OG0006588	3	2	2	0	0	7
OG0006589	1	3	2	1	0	7
OG0006590	1	1	1	3	1	7
OG0006591	2	2	2	1	0	7
OG0006592	1	1	1	3	1	7
OG0006593	1	3	1	2	0	7
OG0006594	1	1	1	4	0	7
OG0006595	1	1	1	3	1	7
OG0006596	3	2	1	1	0	7
OG0006597	2	1	1	2	1	7
OG0006598	1	1	2	2	1	7
OG0006599	2	1	1	2	1	7
OG0006600	1	2	3	1	0	7
OG0006601	3	1	1	1	1	7
OG0006602	1	1	3	1	1	7
OG0006603	2	1	1	2	1	7
OG0006604	1	1	1	3	1	7
OG0006605	1	0	1	5	0	7
OG0006606	1	2	1	2	1	7
OG0006607	1	2	1	2	1	7
OG0006608	1	2	1	2	1	7
OG0006609	2	1	1	2	1	7
OG0006610	2	1	1	3	0	7
OG0006611	2	1	1	3	0	7
OG0006612	1	3	2	1	0	7
OG0006613	1	1	2	2	1	7
OG0006614	1	1	2	2	1	7
OG0006615	1	2	1	2	1	7
OG0006616	1	2	1	2	1	7
OG0006617	2	3	2	0	0	7
OG0006618	2	1	1	3	0	7
OG0006619	2	0	1	4	0	7
OG0006620	2	2	1	1	1	7
OG0006621	1	1	1	2	2	7
OG0006622	1	1	2	1	2	7
OG0006623	2	1	1	2	1	7
OG0006624	2	1	1	2	1	7
OG0006625	1	1	2	2	1	7
OG0006626	3	1	1	1	1	7
OG0006627	1	3	1	2	0	7
OG0006628	1	2	2	1	1	7
OG0006629	2	2	2	1	0	7
OG0006630	2	1	2	1	1	7
OG0006631	1	1	1	4	0	7
OG0006632	1	3	1	1	1	7
OG0006633	1	1	1	2	2	7
OG0006634	2	2	1	2	0	7
OG0006635	1	1	2	2	1	7
OG0006636	1	1	2	3	0	7
OG0006637	1	1	1	2	2	7
OG0006638	1	1	2	2	1	7
OG0006639	1	0	1	4	1	7
OG0006640	1	1	3	1	1	7
OG0006641	1	1	1	3	1	7
OG0006642	1	1	1	3	1	7
OG0006643	1	1	2	2	1	7
OG0006644	1	4	1	1	0	7
OG0006645	1	1	1	3	1	7
OG0006646	2	1	1	2	1	7
OG0006647	2	1	2	1	1	7
OG0006648	4	1	2	0	0	7
OG0006649	4	0	2	1	0	7
OG0006650	1	2	1	2	1	7
OG0006651	2	1	1	2	1	7
OG0006652	1	3	0	2	1	7
OG0006653	1	3	2	1	0	7
OG0006654	3	2	1	1	0	7
OG0006655	1	2	1	3	0	7
OG0006656	1	1	1	2	2	7
OG0006657	1	1	1	4	0	7
OG0006658	2	1	1	2	1	7
OG0006659	1	3	2	1	0	7
OG0006660	1	2	2	2	0	7
OG0006661	1	2	1	1	2	7
OG0006662	2	2	1	1	1	7
OG0006663	1	1	1	3	1	7
OG0006664	1	1	2	2	1	7
OG0006665	1	3	1	1	1	7
OG0006666	1	2	2	1	1	7
OG0006667	2	1	2	1	1	7
OG0006668	1	2	1	2	1	7
OG0006669	1	1	1	3	1	7
OG0006670	1	1	1	4	0	7
OG0006671	1	1	3	1	1	7
OG0006672	1	0	2	4	0	7
OG0006673	1	1	1	4	0	7
OG0006674	1	1	1	3	1	7
OG0006675	3	0	4	0	0	7
OG0006676	1	3	2	1	0	7
OG0006677	1	1	1	4	0	7
OG0006678	3	1	1	1	1	7
OG0006679	1	2	1	2	1	7
OG0006680	2	1	2	2	0	7
OG0006681	2	2	1	2	0	7
OG0006682	1	1	1	3	1	7
OG0006683	2	1	1	2	1	7
OG0006684	1	2	1	2	1	7
OG0006685	2	1	1	3	0	7
OG0006686	1	2	2	1	1	7
OG0006687	1	2	1	2	1	7
OG0006688	3	1	1	1	1	7
OG0006689	2	0	5	0	0	7
OG0006690	2	1	1	2	1	7
OG0006691	4	0	3	0	0	7
OG0006692	1	0	6	0	0	7
OG0006693	1	2	1	3	0	7
OG0006694	3	1	1	2	0	7
OG0006695	1	1	2	1	2	7
OG0006696	1	0	6	0	0	7
OG0006697	2	1	2	1	1	7
OG0006698	7	0	0	0	0	7
OG0006699	1	3	1	1	1	7
OG0006700	1	1	1	3	1	7
OG0006701	1	1	1	4	0	7
OG0006702	1	2	1	2	1	7
OG0006703	1	2	2	2	0	7
OG0006704	1	0	1	4	1	7
OG0006705	1	1	1	4	0	7
OG0006706	2	1	1	2	1	7
OG0006707	2	0	1	2	2	7
OG0006708	1	1	1	4	0	7
OG0006709	2	2	1	1	1	7
OG0006710	1	1	2	3	0	7
OG0006711	1	2	1	2	1	7
OG0006712	1	3	1	2	0	7
OG0006713	1	2	1	2	1	7
OG0006714	2	1	2	2	0	7
OG0006715	1	2	1	1	2	7
OG0006716	1	1	3	1	1	7
OG0006717	1	1	2	2	1	7
OG0006718	2	1	1	2	1	7
OG0006719	1	1	1	4	0	7
OG0006720	1	1	2	2	1	7
OG0006721	1	1	1	4	0	7
OG0006722	2	1	1	2	1	7
OG0006723	1	1	1	3	1	7
OG0006724	2	1	2	2	0	7
OG0006725	1	4	1	1	0	7
OG0006726	1	1	1	4	0	7
OG0006727	1	0	5	1	0	7
OG0006728	2	2	0	2	1	7
OG0006729	2	2	1	2	0	7
OG0006730	1	1	1	3	1	7
OG0006731	2	1	1	2	1	7
OG0006732	1	0	1	4	1	7
OG0006733	2	1	1	2	1	7
OG0006734	2	1	1	2	1	7
OG0006735	1	2	1	2	1	7
OG0006736	2	1	2	1	1	7
OG0006737	2	1	2	1	1	7
OG0006738	1	1	2	2	1	7
OG0006739	3	0	2	1	1	7
OG0006740	1	0	1	4	1	7
OG0006741	6	0	1	0	0	7
OG0006742	3	1	1	1	1	7
OG0006743	2	1	1	2	1	7
OG0006744	1	1	2	2	1	7
OG0006745	2	0	1	4	0	7
OG0006746	1	2	2	2	0	7
OG0006747	1	1	3	2	0	7
OG0006748	1	3	1	1	1	7
OG0006749	3	1	1	2	0	7
OG0006750	1	2	1	2	1	7
OG0006751	1	3	2	1	0	7
OG0006752	1	0	2	3	1	7
OG0006753	1	2	1	2	1	7
OG0006754	1	1	2	3	0	7
OG0006755	1	1	3	1	1	7
OG0006756	1	1	1	3	1	7
OG0006757	1	1	1	3	1	7
OG0006758	1	2	2	2	0	7
OG0006759	1	1	1	3	1	7
OG0006760	1	1	2	2	1	7
OG0006761	1	1	2	2	1	7
OG0006762	1	2	2	1	1	7
OG0006763	1	2	2	2	0	7
OG0006764	1	2	1	2	1	7
OG0006765	1	1	2	2	1	7
OG0006766	1	1	2	1	2	7
OG0006767	2	2	1	1	1	7
OG0006768	2	5	0	0	0	7
OG0006769	1	1	1	4	0	7
OG0006770	2	1	2	1	1	7
OG0006771	3	1	1	1	1	7
OG0006772	1	2	2	1	1	7
OG0006773	2	1	1	3	0	7
OG0006774	1	1	2	2	1	7
OG0006775	1	1	1	4	0	7
OG0006776	2	3	1	1	0	7
OG0006777	1	3	2	0	1	7
OG0006778	1	2	1	2	1	7
OG0006779	1	1	2	3	0	7
OG0006780	5	0	2	0	0	7
OG0006781	1	2	1	2	1	7
OG0006782	1	3	1	1	1	7
OG0006783	1	1	1	3	1	7
OG0006784	1	2	1	2	1	7
OG0006785	1	2	1	3	0	7
OG0006786	1	1	1	4	0	7
OG0006787	1	3	2	1	0	7
OG0006788	1	1	1	3	1	7
OG0006789	1	0	6	0	0	7
OG0006790	1	0	1	4	1	7
OG0006791	1	1	1	4	0	7
OG0006792	1	2	1	3	0	7
OG0006793	1	0	2	3	1	7
OG0006794	1	1	1	3	1	7
OG0006795	1	2	1	2	1	7
OG0006796	2	1	1	2	1	7
OG0006797	1	2	3	1	0	7
OG0006798	1	1	2	2	1	7
OG0006799	1	1	1	3	1	7
OG0006800	1	0	2	3	1	7
OG0006801	1	1	3	1	1	7
OG0006802	3	0	4	0	0	7
OG0006803	3	1	2	1	0	7
OG0006804	1	1	2	2	1	7
OG0006805	2	2	1	2	0	7
OG0006806	1	3	1	1	1	7
OG0006807	1	1	2	2	1	7
OG0006808	3	1	1	2	0	7
OG0006809	1	2	2	2	0	7
OG0006810	2	2	1	1	1	7
OG0006811	2	2	2	0	1	7
OG0006812	1	2	1	2	1	7
OG0006813	1	1	1	3	1	7
OG0006814	1	1	1	2	2	7
OG0006815	1	4	1	0	1	7
OG0006816	1	3	1	1	1	7
OG0006817	1	4	1	0	1	7
OG0006818	2	1	1	3	0	7
OG0006819	1	1	1	3	1	7
OG0006820	2	0	1	4	0	7
OG0006821	1	1	2	2	1	7
OG0006822	2	0	1	4	0	7
OG0006823	1	2	1	3	0	7
OG0006824	1	2	1	2	1	7
OG0006825	2	1	2	2	0	7
OG0006826	2	1	1	2	1	7
OG0006827	1	1	2	2	1	7
OG0006828	2	1	3	1	0	7
OG0006829	1	0	1	4	1	7
OG0006830	2	1	1	2	1	7
OG0006831	1	1	0	4	1	7
OG0006832	1	0	3	3	0	7
OG0006833	1	2	1	3	0	7
OG0006834	1	0	1	4	1	7
OG0006835	1	2	1	3	0	7
OG0006836	1	1	2	2	1	7
OG0006837	1	0	1	4	1	7
OG0006838	2	1	1	2	1	7
OG0006839	2	1	1	2	1	7
OG0006840	1	1	3	1	1	7
OG0006841	1	2	1	2	1	7
OG0006842	2	1	1	2	1	7
OG0006843	1	1	3	1	1	7
OG0006844	4	1	1	1	0	7
OG0006845	1	3	1	2	0	7
OG0006846	2	1	1	2	1	7
OG0006847	2	1	1	3	0	7
OG0006848	1	1	1	3	1	7
OG0006849	1	3	1	1	1	7
OG0006850	5	0	1	0	1	7
OG0006851	1	1	1	3	1	7
OG0006852	1	1	2	3	0	7
OG0006853	1	1	1	3	1	7
OG0006854	1	2	1	2	1	7
OG0006855	3	1	1	2	0	7
OG0006856	2	1	2	1	1	7
OG0006857	1	1	1	3	1	7
OG0006858	2	1	1	2	1	7
OG0006859	1	3	2	1	0	7
OG0006860	2	1	1	2	1	7
OG0006861	1	1	1	3	1	7
OG0006862	2	2	2	1	0	7
OG0006863	1	1	1	3	1	7
OG0006864	2	3	1	1	0	7
OG0006865	1	2	1	3	0	7
OG0006866	1	1	4	1	0	7
OG0006867	1	2	1	2	1	7
OG0006868	6	0	0	0	1	7
OG0006869	1	2	2	1	1	7
OG0006870	1	1	1	3	1	7
OG0006871	1	1	1	2	2	7
OG0006872	1	1	1	3	1	7
OG0006873	1	3	1	1	1	7
OG0006874	1	1	1	3	1	7
OG0006875	1	2	1	3	0	7
OG0006876	1	1	1	2	2	7
OG0006877	2	2	0	3	0	7
OG0006878	1	0	2	3	1	7
OG0006879	1	1	1	4	0	7
OG0006880	1	3	1	1	1	7
OG0006881	2	0	1	3	1	7
OG0006882	1	2	1	2	1	7
OG0006883	2	3	1	1	0	7
OG0006884	1	1	1	3	1	7
OG0006885	1	1	1	3	1	7
OG0006886	1	2	1	2	1	7
OG0006887	2	1	2	2	0	7
OG0006888	1	1	1	4	0	7
OG0006889	1	0	5	0	1	7
OG0006890	1	1	1	4	0	7
OG0006891	1	1	1	3	1	7
OG0006892	1	0	2	4	0	7
OG0006893	7	0	0	0	0	7
OG0006894	3	0	4	0	0	7
OG0006895	1	1	2	2	1	7
OG0006896	1	0	2	3	1	7
OG0006897	1	2	2	2	0	7
OG0006898	2	1	2	2	0	7
OG0006899	1	2	1	3	0	7
OG0006900	1	1	1	4	0	7
OG0006901	1	1	2	2	1	7
OG0006902	1	1	1	3	1	7
OG0006903	1	1	1	4	0	7
OG0006904	2	1	1	2	1	7
OG0006905	1	0	4	2	0	7
OG0006906	1	1	2	3	0	7
OG0006907	1	4	1	1	0	7
OG0006908	2	1	1	2	1	7
OG0006909	1	0	2	4	0	7
OG0006910	1	1	2	2	1	7
OG0006911	1	3	0	3	0	7
OG0006912	1	0	1	3	2	7
OG0006913	1	1	1	4	0	7
OG0006914	1	3	1	2	0	7
OG0006915	1	3	1	1	1	7
OG0006916	2	1	1	2	1	7
OG0006917	1	2	1	2	1	7
OG0006918	2	2	1	1	1	7
OG0006919	1	2	2	1	1	7
OG0006920	1	1	1	4	0	7
OG0006921	1	1	1	3	1	7
OG0006922	2	1	1	2	1	7
OG0006923	3	0	2	2	0	7
OG0006924	1	1	1	4	0	7
OG0006925	1	1	2	2	1	7
OG0006926	1	3	1	2	0	7
OG0006927	1	1	1	3	1	7
OG0006928	1	1	1	3	1	7
OG0006929	4	3	0	0	0	7
OG0006930	1	0	4	2	0	7
OG0006931	2	2	1	2	0	7
OG0006932	1	1	1	3	1	7
OG0006933	1	2	1	2	1	7
OG0006934	1	1	3	1	1	7
OG0006935	1	2	1	2	1	7
OG0006936	1	1	1	4	0	7
OG0006937	1	1	2	2	1	7
OG0006938	1	2	0	4	0	7
OG0006939	1	0	6	0	0	7
OG0006940	1	2	1	2	1	7
OG0006941	1	0	2	4	0	7
OG0006942	1	1	3	2	0	7
OG0006943	1	1	1	4	0	7
OG0006944	1	1	2	3	0	7
OG0006945	2	1	1	2	1	7
OG0006946	1	2	2	1	1	7
OG0006947	1	2	1	3	0	7
OG0006948	1	2	1	2	1	7
OG0006949	1	1	1	3	1	7
OG0006950	2	3	1	1	0	7
OG0006951	1	0	2	3	1	7
OG0006952	1	2	1	3	0	7
OG0006953	3	0	4	0	0	7
OG0006954	1	1	1	2	2	7
OG0006955	1	0	6	0	0	7
OG0006956	1	1	1	3	1	7
OG0006957	1	2	2	2	0	7
OG0006958	1	3	1	2	0	7
OG0006959	1	3	1	1	1	7
OG0006960	1	0	2	3	1	7
OG0006961	1	2	1	2	1	7
OG0006962	1	1	3	1	1	7
OG0006963	1	1	3	1	1	7
OG0006964	2	2	1	2	0	7
OG0006965	1	1	2	2	1	7
OG0006966	4	0	1	2	0	7
OG0006967	1	1	1	4	0	7
OG0006968	1	1	2	2	1	7
OG0006969	1	1	2	2	1	7
OG0006970	1	2	2	1	1	7
OG0006971	1	4	1	1	0	7
OG0006972	1	2	1	2	1	7
OG0006973	1	2	1	2	1	7
OG0006974	1	1	2	2	1	7
OG0006975	1	1	1	3	1	7
OG0006976	1	1	1	3	1	7
OG0006977	1	1	2	2	1	7
OG0006978	1	0	0	0	6	7
OG0006979	1	2	2	2	0	7
OG0006980	1	3	0	3	0	7
OG0006981	1	1	1	3	1	7
OG0006982	1	1	1	3	1	7
OG0006983	1	3	1	1	1	7
OG0006984	1	1	1	4	0	7
OG0006985	2	2	1	1	1	7
OG0006986	2	1	1	2	1	7
OG0006987	2	2	1	1	1	7
OG0006988	2	2	1	2	0	7
OG0006989	2	1	1	2	1	7
OG0006990	1	1	3	2	0	7
OG0006991	2	1	1	3	0	7
OG0006992	1	2	2	1	1	7
OG0006993	1	3	1	2	0	7
OG0006994	1	1	2	2	1	7
OG0006995	1	4	1	1	0	7
OG0006996	2	3	1	1	0	7
OG0006997	1	1	3	1	1	7
OG0006998	1	2	1	2	1	7
OG0006999	1	1	2	2	1	7
OG0007000	1	2	1	2	1	7
OG0007001	1	3	1	1	1	7
OG0007002	2	1	2	1	1	7
OG0007003	1	2	1	2	1	7
OG0007004	1	3	1	1	1	7
OG0007005	1	2	1	2	1	7
OG0007006	2	1	1	2	1	7
OG0007007	3	0	1	2	1	7
OG0007008	1	0	1	4	1	7
OG0007009	1	1	3	1	1	7
OG0007010	1	1	3	1	1	7
OG0007011	1	1	2	2	1	7
OG0007012	3	0	2	2	0	7
OG0007013	1	1	2	2	1	7
OG0007014	2	2	1	1	1	7
OG0007015	1	4	1	1	0	7
OG0007016	2	1	2	1	1	7
OG0007017	1	1	0	5	0	7
OG0007018	2	1	1	3	0	7
OG0007019	2	1	1	2	1	7
OG0007020	1	1	2	2	1	7
OG0007021	1	4	1	0	1	7
OG0007022	1	1	2	1	2	7
OG0007023	1	1	1	4	0	7
OG0007024	1	1	2	1	2	7
OG0007025	1	4	2	0	0	7
OG0007026	1	1	1	3	1	7
OG0007027	1	2	1	2	1	7
OG0007028	2	1	1	2	1	7
OG0007029	1	1	2	2	1	7
OG0007030	1	1	1	3	1	7
OG0007031	1	3	2	1	0	7
OG0007032	2	0	0	5	0	7
OG0007033	3	1	1	1	1	7
OG0007034	1	0	0	6	0	7
OG0007035	2	0	3	2	0	7
OG0007036	1	3	1	2	0	7
OG0007037	5	0	2	0	0	7
OG0007038	1	2	1	3	0	7
OG0007039	2	1	1	2	1	7
OG0007040	1	1	1	4	0	7
OG0007041	1	2	1	2	1	7
OG0007042	1	1	1	4	0	7
OG0007043	1	1	1	2	2	7
OG0007044	1	1	2	0	3	7
OG0007045	1	1	1	3	1	7
OG0007046	2	1	2	1	1	7
OG0007047	1	1	3	1	1	7
OG0007048	1	1	2	2	1	7
OG0007049	2	1	1	1	2	7
OG0007050	1	2	1	2	1	7
OG0007051	1	1	3	1	1	7
OG0007052	1	2	1	2	1	7
OG0007053	1	0	6	0	0	7
OG0007054	1	1	1	3	1	7
OG0007055	1	1	3	1	1	7
OG0007056	1	1	2	2	1	7
OG0007057	1	2	1	2	1	7
OG0007058	2	1	1	2	1	7
OG0007059	1	1	1	3	1	7
OG0007060	1	1	2	2	1	7
OG0007061	1	1	1	3	1	7
OG0007062	1	1	1	4	0	7
OG0007063	1	3	1	2	0	7
OG0007064	1	2	1	2	1	7
OG0007065	1	1	1	4	0	7
OG0007066	3	1	1	1	1	7
OG0007067	1	1	2	2	1	7
OG0007068	3	0	4	0	0	7
OG0007069	4	0	3	0	0	7
OG0007070	1	1	2	3	0	7
OG0007071	1	1	2	2	1	7
OG0007072	2	1	2	1	1	7
OG0007073	1	2	1	2	1	7
OG0007074	1	2	1	2	1	7
OG0007075	3	1	2	1	0	7
OG0007076	1	2	2	1	1	7
OG0007077	2	1	1	3	0	7
OG0007078	1	2	1	2	1	7
OG0007079	2	1	2	1	1	7
OG0007080	0	2	0	3	2	7
OG0007081	0	3	2	2	0	7
OG0007082	0	3	2	2	0	7
OG0007083	0	6	0	1	0	7
OG0007084	0	1	2	3	1	7
OG0007085	0	1	2	2	2	7
OG0007086	0	3	1	2	1	7
OG0007087	0	2	1	4	0	7
OG0007088	0	1	3	3	0	7
OG0007089	0	1	3	1	2	7
OG0007090	0	3	1	3	0	7
OG0007091	0	2	1	4	0	7
OG0007092	0	5	0	2	0	7
OG0007093	0	1	2	2	2	7
OG0007094	0	1	2	3	1	7
OG0007095	0	2	1	4	0	7
OG0007096	0	1	2	3	1	7
OG0007097	0	1	1	5	0	7
OG0007098	0	4	0	3	0	7
OG0007099	0	3	1	3	0	7
OG0007100	0	1	2	4	0	7
OG0007101	0	4	0	3	0	7
OG0007102	0	1	2	3	1	7
OG0007103	0	2	0	5	0	7
OG0007104	0	2	1	3	1	7
OG0007105	0	2	1	3	1	7
OG0007106	0	5	0	2	0	7
OG0007107	0	2	0	5	0	7
OG0007108	0	4	1	1	1	7
OG0007109	0	2	2	2	1	7
OG0007110	0	1	2	3	1	7
OG0007111	0	1	0	5	1	7
OG0007112	0	7	0	0	0	7
OG0007113	0	2	1	3	1	7
OG0007114	0	2	2	2	1	7
OG0007115	0	3	2	1	1	7
OG0007116	0	3	3	1	0	7
OG0007117	0	2	0	5	0	7
OG0007118	0	1	0	6	0	7
OG0007119	0	6	0	1	0	7
OG0007120	0	4	1	2	0	7
OG0007121	0	3	1	2	1	7
OG0007122	0	1	0	6	0	7
OG0007123	0	4	0	3	0	7
OG0007124	0	1	2	1	3	7
OG0007125	0	2	1	4	0	7
OG0007126	0	4	0	3	0	7
OG0007127	0	1	3	2	1	7
OG0007128	0	2	3	2	0	7
OG0007129	0	2	0	5	0	7
OG0007130	0	1	2	3	1	7
OG0007131	0	1	5	1	0	7
OG0007132	0	3	0	4	0	7
OG0007133	0	3	0	4	0	7
OG0007134	0	3	0	4	0	7
OG0007135	0	4	0	3	0	7
OG0007136	0	6	0	0	1	7
OG0007137	0	2	3	2	0	7
OG0007138	0	2	1	3	1	7
OG0007139	0	2	2	3	0	7
OG0007140	0	2	1	3	1	7
OG0007141	0	1	1	5	0	7
OG0007142	0	3	2	2	0	7
OG0007143	0	2	0	4	1	7
OG0007144	0	2	1	3	1	7
OG0007145	0	2	0	5	0	7
OG0007146	0	2	1	4	0	7
OG0007147	0	2	2	3	0	7
OG0007148	0	3	2	1	1	7
OG0007149	0	2	4	0	1	7
OG0007150	0	1	0	6	0	7
OG0007151	0	2	1	4	0	7
OG0007152	0	3	2	0	2	7
OG0007153	0	2	1	3	1	7
OG0007154	0	1	1	3	2	7
OG0007155	0	3	2	1	1	7
OG0007156	0	1	1	5	0	7
OG0007157	0	2	0	5	0	7
OG0007158	0	1	0	6	0	7
OG0007159	0	2	0	5	0	7
OG0007160	0	6	0	1	0	7
OG0007161	0	2	0	5	0	7
OG0007162	0	4	0	3	0	7
OG0007163	0	6	0	1	0	7
OG0007164	0	2	1	3	1	7
OG0007165	0	4	0	3	0	7
OG0007166	0	3	0	4	0	7
OG0007167	0	1	0	6	0	7
OG0007168	0	1	2	4	0	7
OG0007169	0	6	1	0	0	7
OG0007170	0	5	0	2	0	7
OG0007171	0	3	3	0	1	7
OG0007172	0	1	1	5	0	7
OG0007173	0	1	2	4	0	7
OG0007174	0	2	2	2	1	7
OG0007175	0	1	2	3	1	7
OG0007176	0	3	2	2	0	7
OG0007177	0	4	0	3	0	7
OG0007178	0	2	3	2	0	7
OG0007179	0	1	1	3	2	7
OG0007180	0	3	2	2	0	7
OG0007181	0	1	2	3	1	7
OG0007182	0	2	1	3	1	7
OG0007183	0	2	1	2	2	7
OG0007184	0	3	0	4	0	7
OG0007185	0	2	2	3	0	7
OG0007186	0	1	1	4	1	7
OG0007187	0	2	0	5	0	7
OG0007188	0	3	0	3	1	7
OG0007189	0	1	0	6	0	7
OG0007190	0	4	2	1	0	7
OG0007191	0	3	2	1	1	7
OG0007192	0	3	2	1	1	7
OG0007193	0	5	1	1	0	7
OG0007194	0	2	1	4	0	7
OG0007195	0	7	0	0	0	7
OG0007196	0	4	1	1	1	7
OG0007197	0	2	0	5	0	7
OG0007198	0	7	0	0	0	7
OG0007199	0	2	3	2	0	7
OG0007200	0	3	0	4	0	7
OG0007201	0	1	1	4	1	7
OG0007202	0	6	0	1	0	7
OG0007203	0	3	1	3	0	7
OG0007204	0	2	2	3	0	7
OG0007205	0	4	0	2	1	7
OG0007206	0	4	0	3	0	7
OG0007207	0	5	1	1	0	7
OG0007208	0	3	0	4	0	7
OG0007209	0	3	3	1	0	7
OG0007210	0	4	1	0	2	7
OG0007211	0	1	1	3	2	7
OG0007212	0	6	0	1	0	7
OG0007213	0	2	3	2	0	7
OG0007214	0	4	0	3	0	7
OG0007215	0	2	2	3	0	7
OG0007216	0	3	0	4	0	7
OG0007217	0	4	0	3	0	7
OG0007218	0	4	0	3	0	7
OG0007219	0	1	0	6	0	7
OG0007220	0	2	2	3	0	7
OG0007221	0	7	0	0	0	7
OG0007222	0	2	0	5	0	7
OG0007223	0	7	0	0	0	7
OG0007224	0	6	0	1	0	7
OG0007225	0	6	1	0	0	7
OG0007226	0	4	0	3	0	7
OG0007227	0	3	1	2	1	7
OG0007228	0	2	0	5	0	7
OG0007229	0	1	4	2	0	7
OG0007230	0	2	1	3	1	7
OG0007231	0	3	0	4	0	7
OG0007232	0	5	0	2	0	7
OG0007233	0	6	1	0	0	7
OG0007234	0	5	0	2	0	7
OG0007235	0	6	1	0	0	7
OG0007236	0	6	1	0	0	7
OG0007237	0	5	0	2	0	7
OG0007238	0	2	0	5	0	7
OG0007239	0	1	0	6	0	7
OG0007240	0	4	0	3	0	7
OG0007241	0	5	0	2	0	7
OG0007242	0	2	5	0	0	7
OG0007243	0	2	3	2	0	7
OG0007244	0	5	1	0	1	7
OG0007245	0	2	4	1	0	7
OG0007246	0	2	1	3	1	7
OG0007247	0	2	0	2	3	7
OG0007248	0	2	2	2	1	7
OG0007249	0	5	1	1	0	7
OG0007250	0	7	0	0	0	7
OG0007251	0	1	1	5	0	7
OG0007252	0	2	0	5	0	7
OG0007253	0	2	0	1	4	7
OG0007254	0	4	1	1	1	7
OG0007255	0	2	0	5	0	7
OG0007256	0	6	0	1	0	7
OG0007257	0	1	2	4	0	7
OG0007258	0	1	1	4	1	7
OG0007259	0	4	1	1	1	7
OG0007260	0	7	0	0	0	7
OG0007261	0	3	2	2	0	7
OG0007262	0	3	1	1	2	7
OG0007263	0	2	0	5	0	7
OG0007264	0	2	0	5	0	7
OG0007265	0	4	0	3	0	7
OG0007266	0	2	0	5	0	7
OG0007267	0	3	0	4	0	7
OG0007268	0	2	0	5	0	7
OG0007269	0	3	0	4	0	7
OG0007270	0	5	1	1	0	7
OG0007271	0	3	0	4	0	7
OG0007272	0	1	0	6	0	7
OG0007273	0	3	1	3	0	7
OG0007274	0	4	0	2	1	7
OG0007275	0	7	0	0	0	7
OG0007276	0	1	5	1	0	7
OG0007277	0	6	0	1	0	7
OG0007278	0	6	0	1	0	7
OG0007279	0	2	0	4	1	7
OG0007280	0	4	1	1	1	7
OG0007281	0	3	1	2	1	7
OG0007282	0	1	1	5	0	7
OG0007283	0	1	2	4	0	7
OG0007284	0	2	0	5	0	7
OG0007285	0	2	1	4	0	7
OG0007286	0	1	0	6	0	7
OG0007287	0	1	1	5	0	7
OG0007288	0	2	2	2	1	7
OG0007289	0	4	2	1	0	7
OG0007290	0	7	0	0	0	7
OG0007291	0	1	2	4	0	7
OG0007292	0	1	1	4	1	7
OG0007293	0	1	2	4	0	7
OG0007294	0	2	1	2	2	7
OG0007295	0	4	1	2	0	7
OG0007296	0	3	1	3	0	7
OG0007297	0	1	3	2	1	7
OG0007298	0	1	2	4	0	7
OG0007299	0	1	1	3	2	7
OG0007300	0	1	1	4	1	7
OG0007301	0	1	1	5	0	7
OG0007302	0	1	3	2	1	7
OG0007303	0	3	3	1	0	7
OG0007304	0	2	4	0	1	7
OG0007305	0	2	3	2	0	7
OG0007306	0	1	2	3	1	7
OG0007307	0	1	4	2	0	7
OG0007308	0	1	2	4	0	7
OG0007309	0	1	0	6	0	7
OG0007310	0	1	0	6	0	7
OG0007311	0	1	2	3	1	7
OG0007312	0	1	2	4	0	7
OG0007313	0	1	5	1	0	7
OG0007314	0	3	2	0	2	7
OG0007315	0	0	1	6	0	7
OG0007316	0	0	4	3	0	7
OG0007317	0	0	1	6	0	7
OG0007318	0	0	1	6	0	7
OG0007319	0	0	1	4	2	7
OG0007320	0	0	7	0	0	7
OG0007321	0	0	4	0	3	7
OG0007322	0	0	5	2	0	7
OG0007323	0	0	6	0	1	7
OG0007324	0	0	4	0	3	7
OG0007325	0	0	6	1	0	7
OG0007326	0	0	1	6	0	7
OG0007327	0	0	4	2	1	7
OG0007328	0	0	4	0	3	7
OG0007329	0	0	6	0	1	7
OG0007330	0	0	1	6	0	7
OG0007331	0	0	7	0	0	7
OG0007332	0	0	5	2	0	7
OG0007333	0	0	2	5	0	7
OG0007334	0	0	6	0	1	7
OG0007335	0	0	6	1	0	7
OG0007336	0	0	3	0	4	7
OG0007337	0	0	6	1	0	7
OG0007338	0	0	6	0	1	7
OG0007339	0	0	2	5	0	7
OG0007340	0	0	7	0	0	7
OG0007341	0	0	7	0	0	7
OG0007342	0	0	3	4	0	7
OG0007343	0	0	6	1	0	7
OG0007344	0	0	5	2	0	7
OG0007345	0	0	4	1	2	7
OG0007346	0	0	2	5	0	7
OG0007347	0	0	5	0	2	7
OG0007348	0	0	3	4	0	7
OG0007349	0	0	1	6	0	7
OG0007350	0	0	4	2	1	7
OG0007351	0	0	6	1	0	7
OG0007352	0	0	1	6	0	7
OG0007353	0	0	2	0	5	7
OG0007354	0	0	7	0	0	7
OG0007355	0	0	5	1	1	7
OG0007356	0	0	1	6	0	7
OG0007357	0	0	2	5	0	7
OG0007358	0	0	4	0	3	7
OG0007359	0	0	4	1	2	7
OG0007360	0	0	1	6	0	7
OG0007361	0	0	1	6	0	7
OG0007362	0	0	1	6	0	7
OG0007363	0	0	0	7	0	7
OG0007364	0	0	0	7	0	7
OG0007365	0	0	0	7	0	7
OG0007366	0	0	0	7	0	7
OG0007367	0	0	0	7	0	7
OG0007368	0	0	0	7	0	7
OG0007369	0	0	0	4	3	7
OG0007370	0	0	0	7	0	7
OG0007371	0	0	0	4	3	7
OG0007372	0	0	0	7	0	7
OG0007373	0	0	0	7	0	7
OG0007374	0	0	0	7	0	7
OG0007375	0	0	0	7	0	7
OG0007376	0	0	0	7	0	7
OG0007377	0	0	0	7	0	7
OG0007378	0	0	0	7	0	7
OG0007379	0	0	0	5	2	7
OG0007380	0	0	0	7	0	7
OG0007381	0	0	0	7	0	7
OG0007382	0	0	0	7	0	7
OG0007383	0	0	0	7	0	7
OG0007384	0	0	0	7	0	7
OG0007385	0	0	0	7	0	7
OG0007386	0	0	0	7	0	7
OG0007387	0	0	0	7	0	7
OG0007388	0	0	0	7	0	7
OG0007389	0	0	0	7	0	7
OG0007390	0	0	0	1	6	7
OG0007391	0	0	0	7	0	7
OG0007392	0	0	0	7	0	7
OG0007393	0	0	0	7	0	7
OG0007394	0	0	0	6	1	7
OG0007395	0	0	0	7	0	7
OG0007396	0	0	0	7	0	7
OG0007397	0	0	0	7	0	7
OG0007398	0	0	0	7	0	7
OG0007399	0	0	0	7	0	7
OG0007400	0	0	0	7	0	7
OG0007401	0	0	0	7	0	7
OG0007402	0	0	0	5	2	7
OG0007403	0	0	0	4	3	7
OG0007404	0	0	0	2	5	7
OG0007405	0	0	0	7	0	7
OG0007406	0	0	0	7	0	7
OG0007407	0	0	0	6	1	7
OG0007408	0	0	0	7	0	7
OG0007409	0	0	0	7	0	7
OG0007410	0	0	0	1	6	7
OG0007411	0	0	0	0	7	7
OG0007412	0	0	0	0	7	7
OG0007413	0	0	0	0	7	7
OG0007414	0	0	0	0	7	7
OG0007415	0	0	0	0	7	7
OG0007416	5	0	0	1	0	6
OG0007417	1	1	1	2	1	6
OG0007418	1	1	1	2	1	6
OG0007419	2	1	1	1	1	6
OG0007420	1	2	1	2	0	6
OG0007421	1	2	0	2	1	6
OG0007422	1	0	1	3	1	6
OG0007423	1	1	1	3	0	6
OG0007424	1	1	1	2	1	6
OG0007425	2	1	1	1	1	6
OG0007426	1	1	1	2	1	6
OG0007427	1	0	5	0	0	6
OG0007428	1	1	1	2	1	6
OG0007429	1	1	1	2	1	6
OG0007430	5	0	1	0	0	6
OG0007431	2	0	1	2	1	6
OG0007432	1	1	1	1	2	6
OG0007433	1	1	2	1	1	6
OG0007434	1	1	1	3	0	6
OG0007435	1	1	1	2	1	6
OG0007436	1	1	1	2	1	6
OG0007437	1	1	1	2	1	6
OG0007438	1	0	5	0	0	6
OG0007439	1	0	1	2	2	6
OG0007440	1	1	2	1	1	6
OG0007441	1	1	2	1	1	6
OG0007442	1	2	1	2	0	6
OG0007443	1	1	1	1	2	6
OG0007444	3	1	1	1	0	6
OG0007445	1	2	1	1	1	6
OG0007446	1	1	1	2	1	6
OG0007447	2	1	1	1	1	6
OG0007448	1	2	0	3	0	6
OG0007449	1	1	1	2	1	6
OG0007450	1	2	1	1	1	6
OG0007451	1	1	1	2	1	6
OG0007452	1	1	1	3	0	6
OG0007453	1	2	1	1	1	6
OG0007454	3	1	1	1	0	6
OG0007455	1	1	3	1	0	6
OG0007456	3	0	1	1	1	6
OG0007457	1	0	1	3	1	6
OG0007458	1	2	1	1	1	6
OG0007459	1	1	2	2	0	6
OG0007460	1	1	2	2	0	6
OG0007461	1	1	2	2	0	6
OG0007462	1	1	2	2	0	6
OG0007463	1	1	1	2	1	6
OG0007464	1	1	1	3	0	6
OG0007465	1	1	2	2	0	6
OG0007466	1	2	1	1	1	6
OG0007467	1	1	2	1	1	6
OG0007468	1	0	1	3	1	6
OG0007469	1	1	1	2	1	6
OG0007470	4	2	0	0	0	6
OG0007471	2	1	1	1	1	6
OG0007472	2	0	2	0	2	6
OG0007473	1	2	1	1	1	6
OG0007474	1	1	2	2	0	6
OG0007475	1	0	2	2	1	6
OG0007476	1	1	1	1	2	6
OG0007477	1	1	2	1	1	6
OG0007478	1	1	1	2	1	6
OG0007479	4	0	2	0	0	6
OG0007480	4	0	2	0	0	6
OG0007481	6	0	0	0	0	6
OG0007482	1	0	2	3	0	6
OG0007483	1	1	1	2	1	6
OG0007484	3	1	1	1	0	6
OG0007485	1	2	1	1	1	6
OG0007486	1	2	2	1	0	6
OG0007487	1	0	1	3	1	6
OG0007488	1	1	1	2	1	6
OG0007489	1	0	3	2	0	6
OG0007490	2	1	1	1	1	6
OG0007491	2	1	1	2	0	6
OG0007492	1	1	1	3	0	6
OG0007493	1	2	1	1	1	6
OG0007494	1	2	1	1	1	6
OG0007495	1	2	1	1	1	6
OG0007496	2	2	1	1	0	6
OG0007497	1	2	1	1	1	6
OG0007498	1	1	2	2	0	6
OG0007499	1	2	1	2	0	6
OG0007500	1	1	1	2	1	6
OG0007501	5	0	1	0	0	6
OG0007502	1	1	1	2	1	6
OG0007503	2	1	1	1	1	6
OG0007504	1	1	1	2	1	6
OG0007505	1	2	1	2	0	6
OG0007506	2	1	1	1	1	6
OG0007507	1	1	2	1	1	6
OG0007508	1	1	1	2	1	6
OG0007509	1	1	1	1	2	6
OG0007510	1	1	2	1	1	6
OG0007511	3	1	0	2	0	6
OG0007512	2	2	1	1	0	6
OG0007513	2	1	1	2	0	6
OG0007514	1	1	0	4	0	6
OG0007515	1	1	2	1	1	6
OG0007516	1	1	3	1	0	6
OG0007517	1	1	1	2	1	6
OG0007518	2	1	1	1	1	6
OG0007519	1	1	2	1	1	6
OG0007520	1	1	2	2	0	6
OG0007521	1	1	1	2	1	6
OG0007522	2	1	1	1	1	6
OG0007523	1	1	1	2	1	6
OG0007524	1	1	1	2	1	6
OG0007525	6	0	0	0	0	6
OG0007526	2	1	1	2	0	6
OG0007527	2	2	1	1	0	6
OG0007528	1	1	2	2	0	6
OG0007529	3	0	1	2	0	6
OG0007530	1	1	1	2	1	6
OG0007531	2	1	1	1	1	6
OG0007532	1	2	1	1	1	6
OG0007533	6	0	0	0	0	6
OG0007534	1	1	1	2	1	6
OG0007535	1	1	1	2	1	6
OG0007536	1	2	1	1	1	6
OG0007537	1	1	1	2	1	6
OG0007538	1	1	1	2	1	6
OG0007539	1	1	1	2	1	6
OG0007540	1	2	1	2	0	6
OG0007541	1	1	1	2	1	6
OG0007542	1	1	2	2	0	6
OG0007543	2	1	1	2	0	6
OG0007544	1	1	1	2	1	6
OG0007545	1	1	1	2	1	6
OG0007546	1	1	1	3	0	6
OG0007547	1	1	2	2	0	6
OG0007548	2	1	1	1	1	6
OG0007549	1	2	1	1	1	6
OG0007550	1	1	1	2	1	6
OG0007551	1	1	1	2	1	6
OG0007552	1	1	2	1	1	6
OG0007553	2	1	1	1	1	6
OG0007554	1	2	1	1	1	6
OG0007555	1	1	2	1	1	6
OG0007556	1	1	2	1	1	6
OG0007557	1	1	1	2	1	6
OG0007558	1	1	1	2	1	6
OG0007559	1	1	2	2	0	6
OG0007560	1	1	2	1	1	6
OG0007561	2	1	2	1	0	6
OG0007562	1	1	1	3	0	6
OG0007563	1	2	1	1	1	6
OG0007564	1	1	2	1	1	6
OG0007565	1	1	1	2	1	6
OG0007566	1	1	2	1	1	6
OG0007567	1	2	1	1	1	6
OG0007568	1	1	1	2	1	6
OG0007569	1	1	1	1	2	6
OG0007570	1	1	1	2	1	6
OG0007571	4	0	2	0	0	6
OG0007572	1	0	0	5	0	6
OG0007573	6	0	0	0	0	6
OG0007574	1	1	1	2	1	6
OG0007575	1	2	1	1	1	6
OG0007576	1	2	2	1	0	6
OG0007577	1	2	1	1	1	6
OG0007578	1	1	1	3	0	6
OG0007579	2	1	2	1	0	6
OG0007580	1	1	2	1	1	6
OG0007581	1	0	2	2	1	6
OG0007582	1	1	1	2	1	6
OG0007583	1	1	2	1	1	6
OG0007584	3	1	1	1	0	6
OG0007585	2	1	0	3	0	6
OG0007586	1	1	1	3	0	6
OG0007587	1	1	1	1	2	6
OG0007588	1	1	1	3	0	6
OG0007589	1	2	0	3	0	6
OG0007590	2	1	1	1	1	6
OG0007591	6	0	0	0	0	6
OG0007592	1	2	1	1	1	6
OG0007593	1	0	1	4	0	6
OG0007594	3	1	1	1	0	6
OG0007595	2	1	2	1	0	6
OG0007596	2	0	1	2	1	6
OG0007597	1	1	1	2	1	6
OG0007598	2	1	1	1	1	6
OG0007599	2	1	1	1	1	6
OG0007600	1	1	1	3	0	6
OG0007601	1	1	1	3	0	6
OG0007602	2	2	1	1	0	6
OG0007603	1	3	1	1	0	6
OG0007604	2	1	1	1	1	6
OG0007605	1	1	1	2	1	6
OG0007606	1	3	1	1	0	6
OG0007607	3	1	1	1	0	6
OG0007608	1	0	2	2	1	6
OG0007609	1	2	1	2	0	6
OG0007610	1	2	1	1	1	6
OG0007611	1	1	1	2	1	6
OG0007612	1	3	1	1	0	6
OG0007613	2	2	1	1	0	6
OG0007614	1	2	1	1	1	6
OG0007615	1	0	3	2	0	6
OG0007616	1	1	1	3	0	6
OG0007617	2	1	1	1	1	6
OG0007618	1	3	1	1	0	6
OG0007619	2	1	2	1	0	6
OG0007620	1	2	1	2	0	6
OG0007621	1	0	1	4	0	6
OG0007622	1	1	1	2	1	6
OG0007623	1	2	0	3	0	6
OG0007624	1	1	1	2	1	6
OG0007625	2	1	1	1	1	6
OG0007626	1	1	3	1	0	6
OG0007627	1	1	2	1	1	6
OG0007628	1	1	1	2	1	6
OG0007629	1	1	1	2	1	6
OG0007630	1	2	0	2	1	6
OG0007631	1	3	1	1	0	6
OG0007632	2	1	1	1	1	6
OG0007633	1	1	1	2	1	6
OG0007634	1	2	1	2	0	6
OG0007635	2	1	1	2	0	6
OG0007636	1	2	1	2	0	6
OG0007637	1	1	2	1	1	6
OG0007638	1	1	1	1	2	6
OG0007639	1	1	1	2	1	6
OG0007640	1	1	1	3	0	6
OG0007641	1	1	2	1	1	6
OG0007642	2	1	1	2	0	6
OG0007643	1	0	5	0	0	6
OG0007644	1	1	1	1	2	6
OG0007645	2	0	0	0	4	6
OG0007646	1	1	1	2	1	6
OG0007647	1	1	1	2	1	6
OG0007648	1	1	1	2	1	6
OG0007649	1	1	1	2	1	6
OG0007650	2	1	1	1	1	6
OG0007651	1	1	1	2	1	6
OG0007652	1	2	1	1	1	6
OG0007653	1	1	1	2	1	6
OG0007654	1	1	1	3	0	6
OG0007655	1	3	0	2	0	6
OG0007656	1	1	1	2	1	6
OG0007657	1	2	1	2	0	6
OG0007658	1	1	1	2	1	6
OG0007659	1	2	1	2	0	6
OG0007660	1	1	1	2	1	6
OG0007661	1	1	1	3	0	6
OG0007662	1	2	1	1	1	6
OG0007663	2	1	1	1	1	6
OG0007664	1	1	2	2	0	6
OG0007665	2	0	1	2	1	6
OG0007666	6	0	0	0	0	6
OG0007667	3	0	3	0	0	6
OG0007668	2	1	1	1	1	6
OG0007669	2	1	1	1	1	6
OG0007670	1	1	1	2	1	6
OG0007671	1	1	1	2	1	6
OG0007672	2	2	1	1	0	6
OG0007673	1	1	2	1	1	6
OG0007674	1	1	1	2	1	6
OG0007675	1	1	2	1	1	6
OG0007676	1	1	2	1	1	6
OG0007677	1	1	2	2	0	6
OG0007678	3	0	0	0	3	6
OG0007679	1	1	1	2	1	6
OG0007680	1	3	1	1	0	6
OG0007681	1	1	1	2	1	6
OG0007682	1	0	5	0	0	6
OG0007683	1	2	1	1	1	6
OG0007684	1	1	2	1	1	6
OG0007685	1	1	1	1	2	6
OG0007686	2	1	1	1	1	6
OG0007687	1	1	1	2	1	6
OG0007688	2	1	1	1	1	6
OG0007689	1	1	1	1	2	6
OG0007690	1	2	1	1	1	6
OG0007691	1	1	1	2	1	6
OG0007692	1	1	2	1	1	6
OG0007693	1	2	1	1	1	6
OG0007694	1	1	1	2	1	6
OG0007695	2	1	1	2	0	6
OG0007696	2	1	2	1	0	6
OG0007697	1	2	0	2	1	6
OG0007698	1	0	2	2	1	6
OG0007699	1	1	1	2	1	6
OG0007700	1	2	1	2	0	6
OG0007701	1	1	2	1	1	6
OG0007702	1	1	1	2	1	6
OG0007703	1	1	1	2	1	6
OG0007704	1	0	4	1	0	6
OG0007705	1	1	1	2	1	6
OG0007706	1	1	1	2	1	6
OG0007707	1	0	1	3	1	6
OG0007708	2	2	1	1	0	6
OG0007709	1	2	1	1	1	6
OG0007710	1	0	5	0	0	6
OG0007711	1	0	4	1	0	6
OG0007712	1	1	1	2	1	6
OG0007713	1	1	1	2	1	6
OG0007714	1	1	1	2	1	6
OG0007715	1	2	1	1	1	6
OG0007716	1	1	1	2	1	6
OG0007717	1	2	1	1	1	6
OG0007718	1	1	1	2	1	6
OG0007719	1	1	2	1	1	6
OG0007720	1	1	1	2	1	6
OG0007721	1	0	1	3	1	6
OG0007722	1	1	1	2	1	6
OG0007723	1	1	1	2	1	6
OG0007724	1	1	2	1	1	6
OG0007725	1	2	1	1	1	6
OG0007726	2	1	1	1	1	6
OG0007727	1	1	1	2	1	6
OG0007728	1	1	2	1	1	6
OG0007729	2	1	1	1	1	6
OG0007730	1	1	1	3	0	6
OG0007731	1	3	1	1	0	6
OG0007732	1	3	1	1	0	6
OG0007733	1	2	1	1	1	6
OG0007734	1	1	2	1	1	6
OG0007735	3	0	3	0	0	6
OG0007736	3	0	1	2	0	6
OG0007737	2	2	1	1	0	6
OG0007738	1	3	1	1	0	6
OG0007739	2	1	1	1	1	6
OG0007740	1	1	2	2	0	6
OG0007741	1	1	1	2	1	6
OG0007742	1	1	1	2	1	6
OG0007743	1	1	1	2	1	6
OG0007744	1	2	1	1	1	6
OG0007745	2	1	1	1	1	6
OG0007746	1	1	1	3	0	6
OG0007747	3	0	1	2	0	6
OG0007748	1	1	1	2	1	6
OG0007749	2	0	1	0	3	6
OG0007750	1	3	1	1	0	6
OG0007751	1	1	2	1	1	6
OG0007752	1	1	1	2	1	6
OG0007753	1	3	1	1	0	6
OG0007754	2	1	1	2	0	6
OG0007755	2	1	1	1	1	6
OG0007756	1	1	1	2	1	6
OG0007757	1	1	1	3	0	6
OG0007758	1	1	0	2	2	6
OG0007759	1	2	1	2	0	6
OG0007760	1	2	1	2	0	6
OG0007761	1	1	2	2	0	6
OG0007762	6	0	0	0	0	6
OG0007763	1	2	2	1	0	6
OG0007764	2	1	2	1	0	6
OG0007765	3	1	1	1	0	6
OG0007766	1	1	1	2	1	6
OG0007767	1	1	1	2	1	6
OG0007768	2	1	0	3	0	6
OG0007769	1	0	2	2	1	6
OG0007770	1	1	1	2	1	6
OG0007771	1	2	2	1	0	6
OG0007772	1	1	1	2	1	6
OG0007773	1	1	1	1	2	6
OG0007774	1	1	1	2	1	6
OG0007775	1	1	1	2	1	6
OG0007776	1	2	2	1	0	6
OG0007777	1	1	1	2	1	6
OG0007778	1	1	2	1	1	6
OG0007779	1	0	2	2	1	6
OG0007780	2	2	1	1	0	6
OG0007781	1	1	1	1	2	6
OG0007782	1	1	2	1	1	6
OG0007783	1	0	3	1	1	6
OG0007784	1	1	2	2	0	6
OG0007785	1	1	1	2	1	6
OG0007786	1	3	1	1	0	6
OG0007787	1	1	2	1	1	6
OG0007788	1	1	2	2	0	6
OG0007789	1	0	5	0	0	6
OG0007790	2	1	1	2	0	6
OG0007791	1	4	1	0	0	6
OG0007792	1	2	1	2	0	6
OG0007793	4	0	2	0	0	6
OG0007794	1	1	2	2	0	6
OG0007795	1	1	2	1	1	6
OG0007796	1	1	1	2	1	6
OG0007797	1	1	3	1	0	6
OG0007798	2	1	1	1	1	6
OG0007799	5	1	0	0	0	6
OG0007800	1	2	1	1	1	6
OG0007801	4	0	0	2	0	6
OG0007802	1	2	1	1	1	6
OG0007803	1	1	2	1	1	6
OG0007804	1	1	1	1	2	6
OG0007805	1	1	2	2	0	6
OG0007806	1	1	1	2	1	6
OG0007807	1	1	1	2	1	6
OG0007808	1	2	1	1	1	6
OG0007809	1	1	1	2	1	6
OG0007810	1	1	1	2	1	6
OG0007811	1	0	2	2	1	6
OG0007812	1	3	0	2	0	6
OG0007813	1	1	1	2	1	6
OG0007814	1	1	1	2	1	6
OG0007815	1	2	1	1	1	6
OG0007816	3	1	1	1	0	6
OG0007817	1	2	1	1	1	6
OG0007818	1	1	1	2	1	6
OG0007819	1	1	2	1	1	6
OG0007820	3	0	1	1	1	6
OG0007821	1	1	1	2	1	6
OG0007822	6	0	0	0	0	6
OG0007823	1	2	1	2	0	6
OG0007824	1	2	1	1	1	6
OG0007825	1	1	1	3	0	6
OG0007826	1	2	1	1	1	6
OG0007827	2	0	2	1	1	6
OG0007828	1	1	1	3	0	6
OG0007829	1	1	2	1	1	6
OG0007830	1	1	1	2	1	6
OG0007831	2	1	2	1	0	6
OG0007832	1	1	2	1	1	6
OG0007833	1	2	1	2	0	6
OG0007834	1	0	1	3	1	6
OG0007835	2	1	1	1	1	6
OG0007836	1	1	1	3	0	6
OG0007837	1	1	3	1	0	6
OG0007838	1	2	1	2	0	6
OG0007839	2	0	4	0	0	6
OG0007840	1	2	1	1	1	6
OG0007841	1	1	2	2	0	6
OG0007842	1	1	1	2	1	6
OG0007843	1	1	2	2	0	6
OG0007844	1	1	2	1	1	6
OG0007845	6	0	0	0	0	6
OG0007846	1	2	1	1	1	6
OG0007847	2	1	1	2	0	6
OG0007848	1	1	1	2	1	6
OG0007849	1	2	1	2	0	6
OG0007850	1	2	1	2	0	6
OG0007851	1	1	1	2	1	6
OG0007852	1	1	1	2	1	6
OG0007853	1	2	1	1	1	6
OG0007854	2	1	1	2	0	6
OG0007855	1	1	1	2	1	6
OG0007856	1	1	1	2	1	6
OG0007857	1	1	2	2	0	6
OG0007858	1	1	1	2	1	6
OG0007859	2	1	1	1	1	6
OG0007860	1	1	1	3	0	6
OG0007861	1	1	2	2	0	6
OG0007862	1	0	0	5	0	6
OG0007863	1	1	1	2	1	6
OG0007864	1	1	2	2	0	6
OG0007865	1	2	1	2	0	6
OG0007866	1	2	1	1	1	6
OG0007867	1	1	1	2	1	6
OG0007868	1	2	1	1	1	6
OG0007869	1	2	1	2	0	6
OG0007870	1	1	2	2	0	6
OG0007871	1	1	1	2	1	6
OG0007872	1	1	1	2	1	6
OG0007873	1	1	1	3	0	6
OG0007874	1	2	1	1	1	6
OG0007875	1	1	2	1	1	6
OG0007876	2	1	1	2	0	6
OG0007877	1	1	1	2	1	6
OG0007878	1	1	2	1	1	6
OG0007879	1	1	1	2	1	6
OG0007880	1	1	1	3	0	6
OG0007881	5	0	1	0	0	6
OG0007882	1	0	2	2	1	6
OG0007883	1	2	0	2	1	6
OG0007884	1	1	1	2	1	6
OG0007885	1	1	1	3	0	6
OG0007886	1	2	1	1	1	6
OG0007887	1	1	1	2	1	6
OG0007888	2	1	2	1	0	6
OG0007889	1	1	2	2	0	6
OG0007890	1	1	1	2	1	6
OG0007891	1	1	1	2	1	6
OG0007892	2	1	1	1	1	6
OG0007893	1	1	1	2	1	6
OG0007894	1	1	1	2	1	6
OG0007895	1	2	0	3	0	6
OG0007896	2	1	1	2	0	6
OG0007897	1	0	2	2	1	6
OG0007898	1	3	1	1	0	6
OG0007899	1	2	0	2	1	6
OG0007900	1	1	1	2	1	6
OG0007901	3	0	1	2	0	6
OG0007902	3	1	1	1	0	6
OG0007903	1	1	1	2	1	6
OG0007904	1	1	2	2	0	6
OG0007905	1	1	1	2	1	6
OG0007906	1	2	1	1	1	6
OG0007907	1	1	1	3	0	6
OG0007908	1	2	1	2	0	6
OG0007909	1	2	1	2	0	6
OG0007910	4	1	0	1	0	6
OG0007911	3	1	1	1	0	6
OG0007912	1	1	1	2	1	6
OG0007913	1	1	1	2	1	6
OG0007914	1	1	3	0	1	6
OG0007915	1	1	1	2	1	6
OG0007916	1	1	1	2	1	6
OG0007917	1	2	1	1	1	6
OG0007918	2	0	2	2	0	6
OG0007919	2	1	1	2	0	6
OG0007920	2	1	1	1	1	6
OG0007921	1	1	1	2	1	6
OG0007922	1	1	1	2	1	6
OG0007923	3	0	1	2	0	6
OG0007924	4	0	2	0	0	6
OG0007925	2	0	1	3	0	6
OG0007926	1	2	1	2	0	6
OG0007927	1	0	2	2	1	6
OG0007928	1	2	2	1	0	6
OG0007929	1	1	1	2	1	6
OG0007930	1	2	1	1	1	6
OG0007931	1	1	0	2	2	6
OG0007932	1	1	1	2	1	6
OG0007933	1	1	1	2	1	6
OG0007934	1	1	1	1	2	6
OG0007935	1	1	1	1	2	6
OG0007936	1	2	1	1	1	6
OG0007937	1	0	1	4	0	6
OG0007938	1	2	1	1	1	6
OG0007939	1	1	1	2	1	6
OG0007940	1	1	1	2	1	6
OG0007941	1	0	1	3	1	6
OG0007942	1	1	1	2	1	6
OG0007943	3	1	1	0	1	6
OG0007944	1	1	2	2	0	6
OG0007945	1	1	1	2	1	6
OG0007946	1	1	1	2	1	6
OG0007947	1	1	1	2	1	6
OG0007948	1	2	1	1	1	6
OG0007949	1	1	2	1	1	6
OG0007950	2	1	1	2	0	6
OG0007951	1	1	1	3	0	6
OG0007952	1	1	2	1	1	6
OG0007953	1	0	0	5	0	6
OG0007954	1	1	1	2	1	6
OG0007955	1	0	0	5	0	6
OG0007956	1	1	1	2	1	6
OG0007957	1	1	1	2	1	6
OG0007958	1	0	4	1	0	6
OG0007959	1	0	0	5	0	6
OG0007960	1	1	1	2	1	6
OG0007961	1	1	3	1	0	6
OG0007962	2	1	1	1	1	6
OG0007963	1	1	1	2	1	6
OG0007964	1	1	2	1	1	6
OG0007965	2	0	1	2	1	6
OG0007966	2	1	1	2	0	6
OG0007967	1	2	1	1	1	6
OG0007968	2	1	2	1	0	6
OG0007969	2	3	0	1	0	6
OG0007970	1	2	1	2	0	6
OG0007971	1	3	1	1	0	6
OG0007972	1	1	1	3	0	6
OG0007973	2	1	2	1	0	6
OG0007974	1	0	2	1	2	6
OG0007975	1	0	2	1	2	6
OG0007976	1	2	1	1	1	6
OG0007977	1	1	1	2	1	6
OG0007978	1	1	1	3	0	6
OG0007979	1	3	1	1	0	6
OG0007980	1	1	2	1	1	6
OG0007981	1	1	1	2	1	6
OG0007982	1	1	1	2	1	6
OG0007983	1	2	1	1	1	6
OG0007984	2	0	2	1	1	6
OG0007985	5	0	1	0	0	6
OG0007986	4	0	2	0	0	6
OG0007987	2	1	1	1	1	6
OG0007988	1	1	1	2	1	6
OG0007989	1	1	1	2	1	6
OG0007990	1	1	1	1	2	6
OG0007991	1	1	1	2	1	6
OG0007992	0	1	0	5	0	6
OG0007993	0	2	0	4	0	6
OG0007994	0	4	0	2	0	6
OG0007995	0	2	1	2	1	6
OG0007996	0	2	0	3	1	6
OG0007997	0	6	0	0	0	6
OG0007998	0	1	0	1	4	6
OG0007999	0	2	2	1	1	6
OG0008000	0	2	1	3	0	6
OG0008001	0	2	3	1	0	6
OG0008002	0	4	0	2	0	6
OG0008003	0	4	0	2	0	6
OG0008004	0	3	1	2	0	6
OG0008005	0	2	1	3	0	6
OG0008006	0	3	0	3	0	6
OG0008007	0	2	1	2	1	6
OG0008008	0	1	0	5	0	6
OG0008009	0	2	1	3	0	6
OG0008010	0	1	0	5	0	6
OG0008011	0	3	0	3	0	6
OG0008012	0	3	2	1	0	6
OG0008013	0	2	2	1	1	6
OG0008014	0	3	0	3	0	6
OG0008015	0	1	0	5	0	6
OG0008016	0	2	0	4	0	6
OG0008017	0	2	2	1	1	6
OG0008018	0	2	1	2	1	6
OG0008019	0	5	1	0	0	6
OG0008020	0	2	2	2	0	6
OG0008021	0	3	1	1	1	6
OG0008022	0	1	0	5	0	6
OG0008023	0	4	1	1	0	6
OG0008024	0	1	0	5	0	6
OG0008025	0	6	0	0	0	6
OG0008026	0	1	0	5	0	6
OG0008027	0	1	1	2	2	6
OG0008028	0	2	0	4	0	6
OG0008029	0	1	2	3	0	6
OG0008030	0	2	1	3	0	6
OG0008031	0	3	2	1	0	6
OG0008032	0	1	0	5	0	6
OG0008033	0	3	0	3	0	6
OG0008034	0	5	0	1	0	6
OG0008035	0	4	0	2	0	6
OG0008036	0	3	0	3	0	6
OG0008037	0	2	0	4	0	6
OG0008038	0	4	2	0	0	6
OG0008039	0	2	1	2	1	6
OG0008040	0	3	1	1	1	6
OG0008041	0	2	1	3	0	6
OG0008042	0	1	1	4	0	6
OG0008043	0	3	1	1	1	6
OG0008044	0	1	0	5	0	6
OG0008045	0	2	1	1	2	6
OG0008046	0	3	0	1	2	6
OG0008047	0	5	0	1	0	6
OG0008048	0	3	1	2	0	6
OG0008049	0	2	0	4	0	6
OG0008050	0	3	1	2	0	6
OG0008051	0	1	1	4	0	6
OG0008052	0	3	1	2	0	6
OG0008053	0	2	1	3	0	6
OG0008054	0	5	0	1	0	6
OG0008055	0	1	3	2	0	6
OG0008056	0	3	0	3	0	6
OG0008057	0	1	0	5	0	6
OG0008058	0	3	0	3	0	6
OG0008059	0	3	2	1	0	6
OG0008060	0	2	1	2	1	6
OG0008061	0	1	0	5	0	6
OG0008062	0	4	0	2	0	6
OG0008063	0	2	0	4	0	6
OG0008064	0	2	0	4	0	6
OG0008065	0	2	1	2	1	6
OG0008066	0	2	1	3	0	6
OG0008067	0	1	3	2	0	6
OG0008068	0	2	1	3	0	6
OG0008069	0	5	0	0	1	6
OG0008070	0	2	0	4	0	6
OG0008071	0	2	0	4	0	6
OG0008072	0	2	1	3	0	6
OG0008073	0	2	3	1	0	6
OG0008074	0	1	3	2	0	6
OG0008075	0	1	0	5	0	6
OG0008076	0	1	2	2	1	6
OG0008077	0	6	0	0	0	6
OG0008078	0	1	4	1	0	6
OG0008079	0	4	0	2	0	6
OG0008080	0	1	0	5	0	6
OG0008081	0	3	0	3	0	6
OG0008082	0	2	1	3	0	6
OG0008083	0	6	0	0	0	6
OG0008084	0	1	0	5	0	6
OG0008085	0	1	0	5	0	6
OG0008086	0	1	0	5	0	6
OG0008087	0	4	0	2	0	6
OG0008088	0	1	0	5	0	6
OG0008089	0	1	1	3	1	6
OG0008090	0	2	0	4	0	6
OG0008091	0	5	0	1	0	6
OG0008092	0	6	0	0	0	6
OG0008093	0	2	1	2	1	6
OG0008094	0	1	4	1	0	6
OG0008095	0	5	0	1	0	6
OG0008096	0	2	1	3	0	6
OG0008097	0	1	1	4	0	6
OG0008098	0	4	0	2	0	6
OG0008099	0	2	2	1	1	6
OG0008100	0	1	1	2	2	6
OG0008101	0	2	1	3	0	6
OG0008102	0	2	1	2	1	6
OG0008103	0	6	0	0	0	6
OG0008104	0	1	2	2	1	6
OG0008105	0	1	0	5	0	6
OG0008106	0	2	1	2	1	6
OG0008107	0	1	0	5	0	6
OG0008108	0	2	0	2	2	6
OG0008109	0	1	4	1	0	6
OG0008110	0	3	1	2	0	6
OG0008111	0	4	1	1	0	6
OG0008112	0	5	0	1	0	6
OG0008113	0	6	0	0	0	6
OG0008114	0	1	1	3	1	6
OG0008115	0	6	0	0	0	6
OG0008116	0	1	0	5	0	6
OG0008117	0	4	0	2	0	6
OG0008118	0	3	0	1	2	6
OG0008119	0	3	2	1	0	6
OG0008120	0	3	2	1	0	6
OG0008121	0	4	0	2	0	6
OG0008122	0	4	0	2	0	6
OG0008123	0	3	1	2	0	6
OG0008124	0	1	4	0	1	6
OG0008125	0	5	0	1	0	6
OG0008126	0	2	0	4	0	6
OG0008127	0	2	2	1	1	6
OG0008128	0	2	0	4	0	6
OG0008129	0	2	1	2	1	6
OG0008130	0	1	0	5	0	6
OG0008131	0	5	1	0	0	6
OG0008132	0	4	0	1	1	6
OG0008133	0	6	0	0	0	6
OG0008134	0	6	0	0	0	6
OG0008135	0	3	1	1	1	6
OG0008136	0	1	0	5	0	6
OG0008137	0	1	0	5	0	6
OG0008138	0	1	1	4	0	6
OG0008139	0	4	1	1	0	6
OG0008140	0	2	2	2	0	6
OG0008141	0	4	0	2	0	6
OG0008142	0	2	0	4	0	6
OG0008143	0	4	0	2	0	6
OG0008144	0	2	0	4	0	6
OG0008145	0	2	1	0	3	6
OG0008146	0	2	2	2	0	6
OG0008147	0	3	1	2	0	6
OG0008148	0	1	1	4	0	6
OG0008149	0	3	0	2	1	6
OG0008150	0	1	0	5	0	6
OG0008151	0	1	1	2	2	6
OG0008152	0	5	0	1	0	6
OG0008153	0	1	2	2	1	6
OG0008154	0	2	1	2	1	6
OG0008155	0	1	0	5	0	6
OG0008156	0	3	1	1	1	6
OG0008157	0	2	1	3	0	6
OG0008158	0	3	0	3	0	6
OG0008159	0	2	2	2	0	6
OG0008160	0	3	0	3	0	6
OG0008161	0	2	0	4	0	6
OG0008162	0	4	0	2	0	6
OG0008163	0	2	1	3	0	6
OG0008164	0	2	1	3	0	6
OG0008165	0	4	0	2	0	6
OG0008166	0	3	2	1	0	6
OG0008167	0	1	0	5	0	6
OG0008168	0	3	1	2	0	6
OG0008169	0	2	0	4	0	6
OG0008170	0	5	0	1	0	6
OG0008171	0	3	1	1	1	6
OG0008172	0	2	2	1	1	6
OG0008173	0	2	1	3	0	6
OG0008174	0	2	1	3	0	6
OG0008175	0	3	2	1	0	6
OG0008176	0	2	0	4	0	6
OG0008177	0	1	0	5	0	6
OG0008178	0	3	1	2	0	6
OG0008179	0	1	1	4	0	6
OG0008180	0	3	0	3	0	6
OG0008181	0	1	1	3	1	6
OG0008182	0	3	0	3	0	6
OG0008183	0	1	3	1	1	6
OG0008184	0	2	0	4	0	6
OG0008185	0	2	1	2	1	6
OG0008186	0	2	0	4	0	6
OG0008187	0	6	0	0	0	6
OG0008188	0	5	1	0	0	6
OG0008189	0	4	0	2	0	6
OG0008190	0	2	1	3	0	6
OG0008191	0	3	0	3	0	6
OG0008192	0	3	0	3	0	6
OG0008193	0	2	0	4	0	6
OG0008194	0	2	2	2	0	6
OG0008195	0	3	0	3	0	6
OG0008196	0	2	1	1	2	6
OG0008197	0	1	4	1	0	6
OG0008198	0	2	1	1	2	6
OG0008199	0	3	0	3	0	6
OG0008200	0	3	0	3	0	6
OG0008201	0	2	0	4	0	6
OG0008202	0	1	0	5	0	6
OG0008203	0	2	0	4	0	6
OG0008204	0	3	1	1	1	6
OG0008205	0	1	2	2	1	6
OG0008206	0	1	0	5	0	6
OG0008207	0	1	1	2	2	6
OG0008208	0	5	1	0	0	6
OG0008209	0	3	1	2	0	6
OG0008210	0	2	0	4	0	6
OG0008211	0	1	0	5	0	6
OG0008212	0	2	0	4	0	6
OG0008213	0	1	2	1	2	6
OG0008214	0	3	1	2	0	6
OG0008215	0	1	1	4	0	6
OG0008216	0	2	1	2	1	6
OG0008217	0	2	2	1	1	6
OG0008218	0	1	0	5	0	6
OG0008219	0	5	0	0	1	6
OG0008220	0	2	0	4	0	6
OG0008221	0	1	0	5	0	6
OG0008222	0	2	1	1	2	6
OG0008223	0	1	0	5	0	6
OG0008224	0	3	1	2	0	6
OG0008225	0	2	1	2	1	6
OG0008226	0	2	1	2	1	6
OG0008227	0	1	0	5	0	6
OG0008228	0	4	0	2	0	6
OG0008229	0	3	0	3	0	6
OG0008230	0	1	1	4	0	6
OG0008231	0	2	0	4	0	6
OG0008232	0	4	1	1	0	6
OG0008233	0	1	1	4	0	6
OG0008234	0	2	1	2	1	6
OG0008235	0	1	2	3	0	6
OG0008236	0	1	2	1	2	6
OG0008237	0	3	1	2	0	6
OG0008238	0	1	0	3	2	6
OG0008239	0	2	2	1	1	6
OG0008240	0	2	0	3	1	6
OG0008241	0	1	1	4	0	6
OG0008242	0	1	0	5	0	6
OG0008243	0	1	1	4	0	6
OG0008244	0	1	0	5	0	6
OG0008245	0	1	0	5	0	6
OG0008246	0	1	0	5	0	6
OG0008247	0	2	3	1	0	6
OG0008248	0	2	1	3	0	6
OG0008249	0	1	0	5	0	6
OG0008250	0	1	2	3	0	6
OG0008251	0	1	1	4	0	6
OG0008252	0	1	1	3	1	6
OG0008253	0	1	1	3	1	6
OG0008254	0	1	0	5	0	6
OG0008255	0	1	0	5	0	6
OG0008256	0	3	1	2	0	6
OG0008257	0	1	1	3	1	6
OG0008258	0	1	2	1	2	6
OG0008259	0	1	2	2	1	6
OG0008260	0	1	0	5	0	6
OG0008261	0	1	1	4	0	6
OG0008262	0	3	1	1	1	6
OG0008263	0	1	3	2	0	6
OG0008264	0	1	2	3	0	6
OG0008265	0	1	0	5	0	6
OG0008266	0	1	0	5	0	6
OG0008267	0	1	0	5	0	6
OG0008268	0	1	2	2	1	6
OG0008269	0	1	3	2	0	6
OG0008270	0	1	0	5	0	6
OG0008271	0	1	2	1	2	6
OG0008272	0	1	1	2	2	6
OG0008273	0	1	0	5	0	6
OG0008274	0	1	2	2	1	6
OG0008275	0	1	1	2	2	6
OG0008276	0	1	1	4	0	6
OG0008277	0	0	3	1	2	6
OG0008278	0	0	2	0	4	6
OG0008279	0	0	6	0	0	6
OG0008280	0	0	3	3	0	6
OG0008281	0	0	1	4	1	6
OG0008282	0	0	6	0	0	6
OG0008283	0	0	3	2	1	6
OG0008284	0	0	5	1	0	6
OG0008285	0	0	1	4	1	6
OG0008286	0	0	1	5	0	6
OG0008287	0	0	1	5	0	6
OG0008288	0	0	5	0	1	6
OG0008289	0	0	5	1	0	6
OG0008290	0	0	5	1	0	6
OG0008291	0	0	5	0	1	6
OG0008292	0	0	2	3	1	6
OG0008293	0	0	1	4	1	6
OG0008294	0	0	6	0	0	6
OG0008295	0	0	6	0	0	6
OG0008296	0	0	6	0	0	6
OG0008297	0	0	3	0	3	6
OG0008298	0	0	6	0	0	6
OG0008299	0	0	1	4	1	6
OG0008300	0	0	5	0	1	6
OG0008301	0	0	1	4	1	6
OG0008302	0	0	1	5	0	6
OG0008303	0	0	6	0	0	6
OG0008304	0	0	5	1	0	6
OG0008305	0	0	2	0	4	6
OG0008306	0	0	1	5	0	6
OG0008307	0	0	1	4	1	6
OG0008308	0	0	1	1	4	6
OG0008309	0	0	2	4	0	6
OG0008310	0	0	4	2	0	6
OG0008311	0	0	2	4	0	6
OG0008312	0	0	5	1	0	6
OG0008313	0	0	5	1	0	6
OG0008314	0	0	2	3	1	6
OG0008315	0	0	5	0	1	6
OG0008316	0	0	1	5	0	6
OG0008317	0	0	1	4	1	6
OG0008318	0	0	2	0	4	6
OG0008319	0	0	1	5	0	6
OG0008320	0	0	3	2	1	6
OG0008321	0	0	1	5	0	6
OG0008322	0	0	1	5	0	6
OG0008323	0	0	4	0	2	6
OG0008324	0	0	6	0	0	6
OG0008325	0	0	2	4	0	6
OG0008326	0	0	2	3	1	6
OG0008327	0	0	1	5	0	6
OG0008328	0	0	4	2	0	6
OG0008329	0	0	6	0	0	6
OG0008330	0	0	1	4	1	6
OG0008331	0	0	1	4	1	6
OG0008332	0	0	1	5	0	6
OG0008333	0	0	4	2	0	6
OG0008334	0	0	2	4	0	6
OG0008335	0	0	4	1	1	6
OG0008336	0	0	2	4	0	6
OG0008337	0	0	6	0	0	6
OG0008338	0	0	1	5	0	6
OG0008339	0	0	3	0	3	6
OG0008340	0	0	4	0	2	6
OG0008341	0	0	2	3	1	6
OG0008342	0	0	4	0	2	6
OG0008343	0	0	1	2	3	6
OG0008344	0	0	5	0	1	6
OG0008345	0	0	5	1	0	6
OG0008346	0	0	1	5	0	6
OG0008347	0	0	1	0	5	6
OG0008348	0	0	1	5	0	6
OG0008349	0	0	2	3	1	6
OG0008350	0	0	1	5	0	6
OG0008351	0	0	0	6	0	6
OG0008352	0	0	0	6	0	6
OG0008353	0	0	0	6	0	6
OG0008354	0	0	0	5	1	6
OG0008355	0	0	0	6	0	6
OG0008356	0	0	0	6	0	6
OG0008357	0	0	0	6	0	6
OG0008358	0	0	0	6	0	6
OG0008359	0	0	0	6	0	6
OG0008360	0	0	0	6	0	6
OG0008361	0	0	0	6	0	6
OG0008362	0	0	0	6	0	6
OG0008363	0	0	0	6	0	6
OG0008364	0	0	0	6	0	6
OG0008365	0	0	0	6	0	6
OG0008366	0	0	0	6	0	6
OG0008367	0	0	0	6	0	6
OG0008368	0	0	0	6	0	6
OG0008369	0	0	0	6	0	6
OG0008370	0	0	0	6	0	6
OG0008371	0	0	0	6	0	6
OG0008372	0	0	0	6	0	6
OG0008373	0	0	0	6	0	6
OG0008374	0	0	0	6	0	6
OG0008375	0	0	0	6	0	6
OG0008376	0	0	0	6	0	6
OG0008377	0	0	0	6	0	6
OG0008378	0	0	0	6	0	6
OG0008379	0	0	0	6	0	6
OG0008380	0	0	0	6	0	6
OG0008381	0	0	0	6	0	6
OG0008382	0	0	0	6	0	6
OG0008383	0	0	0	6	0	6
OG0008384	0	0	0	6	0	6
OG0008385	0	0	0	6	0	6
OG0008386	0	0	0	6	0	6
OG0008387	0	0	0	5	1	6
OG0008388	0	0	0	6	0	6
OG0008389	0	0	0	6	0	6
OG0008390	0	0	0	6	0	6
OG0008391	0	0	0	6	0	6
OG0008392	0	0	0	5	1	6
OG0008393	0	0	0	4	2	6
OG0008394	0	0	0	6	0	6
OG0008395	0	0	0	6	0	6
OG0008396	0	0	0	1	5	6
OG0008397	0	0	0	2	4	6
OG0008398	0	0	0	6	0	6
OG0008399	0	0	0	4	2	6
OG0008400	0	0	0	6	0	6
OG0008401	0	0	0	5	1	6
OG0008402	0	0	0	0	6	6
OG0008403	0	0	0	0	6	6
OG0008404	0	0	0	0	6	6
OG0008405	0	0	0	0	6	6
OG0008406	5	0	0	0	0	5
OG0008407	3	0	2	0	0	5
OG0008408	2	1	1	1	0	5
OG0008409	1	1	2	1	0	5
OG0008410	1	1	1	1	1	5
OG0008411	1	0	1	2	1	5
OG0008412	1	1	1	2	0	5
OG0008413	1	2	1	1	0	5
OG0008414	1	1	1	1	1	5
OG0008415	1	1	1	1	1	5
OG0008416	1	1	1	1	1	5
OG0008417	1	1	1	1	1	5
OG0008418	1	1	1	2	0	5
OG0008419	1	1	1	2	0	5
OG0008420	1	1	1	1	1	5
OG0008421	4	0	1	0	0	5
OG0008422	5	0	0	0	0	5
OG0008423	1	0	4	0	0	5
OG0008424	5	0	0	0	0	5
OG0008425	1	0	2	2	0	5
OG0008426	1	0	1	3	0	5
OG0008427	1	1	1	2	0	5
OG0008428	1	1	2	1	0	5
OG0008429	1	1	1	2	0	5
OG0008430	2	1	1	1	0	5
OG0008431	1	1	1	1	1	5
OG0008432	1	1	1	2	0	5
OG0008433	2	1	1	1	0	5
OG0008434	1	2	1	1	0	5
OG0008435	1	0	4	0	0	5
OG0008436	1	0	4	0	0	5
OG0008437	1	1	1	1	1	5
OG0008438	1	1	1	1	1	5
OG0008439	1	1	1	1	1	5
OG0008440	2	1	0	2	0	5
OG0008441	1	1	1	1	1	5
OG0008442	1	0	1	1	2	5
OG0008443	1	0	1	2	1	5
OG0008444	1	2	1	1	0	5
OG0008445	1	1	1	2	0	5
OG0008446	1	1	1	1	1	5
OG0008447	1	1	1	1	1	5
OG0008448	1	2	1	1	0	5
OG0008449	1	1	1	2	0	5
OG0008450	1	2	1	1	0	5
OG0008451	1	0	2	2	0	5
OG0008452	1	1	1	2	0	5
OG0008453	1	0	1	1	2	5
OG0008454	1	0	1	3	0	5
OG0008455	5	0	0	0	0	5
OG0008456	1	1	1	2	0	5
OG0008457	1	1	1	2	0	5
OG0008458	1	1	1	1	1	5
OG0008459	1	1	1	1	1	5
OG0008460	2	1	1	1	0	5
OG0008461	1	0	3	0	1	5
OG0008462	1	1	1	1	1	5
OG0008463	1	1	1	2	0	5
OG0008464	1	1	1	2	0	5
OG0008465	1	1	1	1	1	5
OG0008466	2	0	0	3	0	5
OG0008467	1	2	1	1	0	5
OG0008468	1	1	1	1	1	5
OG0008469	1	1	1	1	1	5
OG0008470	1	1	1	2	0	5
OG0008471	2	0	1	1	1	5
OG0008472	1	1	1	1	1	5
OG0008473	1	1	1	2	0	5
OG0008474	1	1	1	2	0	5
OG0008475	1	1	1	2	0	5
OG0008476	1	1	1	1	1	5
OG0008477	1	1	1	1	1	5
OG0008478	3	0	2	0	0	5
OG0008479	1	1	1	1	1	5
OG0008480	1	1	1	2	0	5
OG0008481	1	1	1	1	1	5
OG0008482	2	1	1	1	0	5
OG0008483	1	1	1	2	0	5
OG0008484	2	0	1	1	1	5
OG0008485	1	1	2	1	0	5
OG0008486	1	1	1	1	1	5
OG0008487	4	0	1	0	0	5
OG0008488	1	1	1	2	0	5
OG0008489	1	1	1	2	0	5
OG0008490	1	1	1	1	1	5
OG0008491	1	1	1	1	1	5
OG0008492	4	0	0	1	0	5
OG0008493	1	0	4	0	0	5
OG0008494	1	0	1	2	1	5
OG0008495	1	1	1	1	1	5
OG0008496	1	1	1	1	1	5
OG0008497	1	1	1	1	1	5
OG0008498	1	1	1	1	1	5
OG0008499	2	1	1	1	0	5
OG0008500	1	0	1	3	0	5
OG0008501	1	1	1	1	1	5
OG0008502	1	1	1	1	1	5
OG0008503	1	1	1	2	0	5
OG0008504	1	1	1	1	1	5
OG0008505	2	0	1	2	0	5
OG0008506	2	1	1	1	0	5
OG0008507	1	0	1	3	0	5
OG0008508	1	1	1	2	0	5
OG0008509	3	0	2	0	0	5
OG0008510	1	1	1	1	1	5
OG0008511	1	1	1	2	0	5
OG0008512	1	1	1	2	0	5
OG0008513	1	1	1	1	1	5
OG0008514	1	2	1	1	0	5
OG0008515	1	1	1	1	1	5
OG0008516	1	1	1	1	1	5
OG0008517	1	1	1	2	0	5
OG0008518	5	0	0	0	0	5
OG0008519	1	1	1	2	0	5
OG0008520	1	1	2	1	0	5
OG0008521	2	2	0	1	0	5
OG0008522	1	1	1	2	0	5
OG0008523	1	1	1	1	1	5
OG0008524	1	1	1	1	1	5
OG0008525	1	0	2	1	1	5
OG0008526	1	1	1	1	1	5
OG0008527	1	1	1	1	1	5
OG0008528	1	1	1	1	1	5
OG0008529	1	1	2	1	0	5
OG0008530	1	1	1	2	0	5
OG0008531	1	1	0	2	1	5
OG0008532	1	2	1	1	0	5
OG0008533	1	0	1	2	1	5
OG0008534	1	1	1	1	1	5
OG0008535	1	1	1	1	1	5
OG0008536	1	1	1	1	1	5
OG0008537	1	1	1	1	1	5
OG0008538	1	1	1	1	1	5
OG0008539	1	1	1	1	1	5
OG0008540	2	1	1	1	0	5
OG0008541	1	1	1	1	1	5
OG0008542	1	1	2	1	0	5
OG0008543	1	0	3	0	1	5
OG0008544	1	2	1	1	0	5
OG0008545	5	0	0	0	0	5
OG0008546	1	0	2	2	0	5
OG0008547	1	1	1	1	1	5
OG0008548	1	1	0	2	1	5
OG0008549	1	2	1	1	0	5
OG0008550	1	1	1	2	0	5
OG0008551	1	1	1	1	1	5
OG0008552	1	1	1	1	1	5
OG0008553	1	1	1	1	1	5
OG0008554	1	1	1	1	1	5
OG0008555	1	1	1	2	0	5
OG0008556	1	1	1	1	1	5
OG0008557	1	1	1	1	1	5
OG0008558	1	0	1	2	1	5
OG0008559	2	1	1	1	0	5
OG0008560	1	1	1	1	1	5
OG0008561	1	1	1	2	0	5
OG0008562	5	0	0	0	0	5
OG0008563	4	0	1	0	0	5
OG0008564	1	1	2	0	1	5
OG0008565	1	1	1	1	1	5
OG0008566	1	3	1	0	0	5
OG0008567	1	1	1	1	1	5
OG0008568	1	1	1	1	1	5
OG0008569	1	1	1	1	1	5
OG0008570	2	0	1	2	0	5
OG0008571	1	1	1	1	1	5
OG0008572	1	1	1	2	0	5
OG0008573	1	1	1	1	1	5
OG0008574	1	1	1	2	0	5
OG0008575	1	1	1	1	1	5
OG0008576	5	0	0	0	0	5
OG0008577	1	1	1	2	0	5
OG0008578	2	0	1	1	1	5
OG0008579	1	0	1	3	0	5
OG0008580	1	0	2	0	2	5
OG0008581	1	1	1	1	1	5
OG0008582	1	2	1	1	0	5
OG0008583	1	1	1	1	1	5
OG0008584	1	1	1	1	1	5
OG0008585	1	1	2	1	0	5
OG0008586	1	1	1	1	1	5
OG0008587	2	0	3	0	0	5
OG0008588	1	1	1	1	1	5
OG0008589	1	1	1	1	1	5
OG0008590	1	1	1	1	1	5
OG0008591	2	1	1	1	0	5
OG0008592	1	1	1	1	1	5
OG0008593	1	2	1	1	0	5
OG0008594	1	0	1	3	0	5
OG0008595	1	1	1	1	1	5
OG0008596	1	1	1	2	0	5
OG0008597	1	1	1	1	1	5
OG0008598	5	0	0	0	0	5
OG0008599	1	1	1	1	1	5
OG0008600	1	1	1	1	1	5
OG0008601	2	0	0	3	0	5
OG0008602	1	1	1	1	1	5
OG0008603	1	1	1	2	0	5
OG0008604	1	1	1	2	0	5
OG0008605	5	0	0	0	0	5
OG0008606	1	2	1	1	0	5
OG0008607	1	0	1	3	0	5
OG0008608	4	0	1	0	0	5
OG0008609	1	1	1	2	0	5
OG0008610	1	1	1	2	0	5
OG0008611	1	1	1	1	1	5
OG0008612	1	1	1	2	0	5
OG0008613	1	1	0	3	0	5
OG0008614	1	1	1	1	1	5
OG0008615	1	0	1	2	1	5
OG0008616	1	1	1	2	0	5
OG0008617	1	1	0	3	0	5
OG0008618	1	2	1	1	0	5
OG0008619	1	1	1	2	0	5
OG0008620	1	1	1	1	1	5
OG0008621	1	1	1	1	1	5
OG0008622	1	0	2	1	1	5
OG0008623	1	1	1	2	0	5
OG0008624	1	1	1	2	0	5
OG0008625	1	1	1	1	1	5
OG0008626	1	1	1	1	1	5
OG0008627	1	1	1	1	1	5
OG0008628	1	0	1	2	1	5
OG0008629	2	0	1	2	0	5
OG0008630	1	0	2	2	0	5
OG0008631	1	1	0	2	1	5
OG0008632	1	1	1	1	1	5
OG0008633	3	0	1	0	1	5
OG0008634	1	0	4	0	0	5
OG0008635	1	1	1	1	1	5
OG0008636	4	0	1	0	0	5
OG0008637	1	1	1	2	0	5
OG0008638	1	1	1	2	0	5
OG0008639	1	0	4	0	0	5
OG0008640	1	1	1	2	0	5
OG0008641	1	0	3	0	1	5
OG0008642	1	2	1	1	0	5
OG0008643	2	0	1	1	1	5
OG0008644	1	1	2	1	0	5
OG0008645	2	1	1	1	0	5
OG0008646	1	1	1	1	1	5
OG0008647	1	1	0	2	1	5
OG0008648	2	1	0	2	0	5
OG0008649	1	1	1	2	0	5
OG0008650	1	1	1	2	0	5
OG0008651	1	1	1	2	0	5
OG0008652	1	1	1	2	0	5
OG0008653	1	1	1	1	1	5
OG0008654	1	0	2	2	0	5
OG0008655	1	1	1	2	0	5
OG0008656	1	1	1	1	1	5
OG0008657	1	1	1	2	0	5
OG0008658	2	1	1	1	0	5
OG0008659	1	1	0	2	1	5
OG0008660	5	0	0	0	0	5
OG0008661	1	1	1	1	1	5
OG0008662	1	1	1	1	1	5
OG0008663	1	0	2	0	2	5
OG0008664	1	1	1	2	0	5
OG0008665	1	0	3	0	1	5
OG0008666	1	1	1	2	0	5
OG0008667	1	1	1	1	1	5
OG0008668	1	1	1	1	1	5
OG0008669	1	1	1	2	0	5
OG0008670	1	1	2	1	0	5
OG0008671	1	1	1	2	0	5
OG0008672	4	0	1	0	0	5
OG0008673	1	1	1	2	0	5
OG0008674	1	1	1	2	0	5
OG0008675	1	1	1	2	0	5
OG0008676	1	1	1	2	0	5
OG0008677	1	1	1	1	1	5
OG0008678	1	1	2	1	0	5
OG0008679	1	0	1	2	1	5
OG0008680	1	1	1	2	0	5
OG0008681	1	1	0	2	1	5
OG0008682	1	1	1	1	1	5
OG0008683	1	1	1	1	1	5
OG0008684	1	1	1	1	1	5
OG0008685	2	0	2	1	0	5
OG0008686	4	0	1	0	0	5
OG0008687	1	1	1	1	1	5
OG0008688	1	1	1	1	1	5
OG0008689	2	1	0	2	0	5
OG0008690	1	1	1	2	0	5
OG0008691	1	1	1	1	1	5
OG0008692	1	1	2	1	0	5
OG0008693	5	0	0	0	0	5
OG0008694	1	1	1	2	0	5
OG0008695	1	0	2	2	0	5
OG0008696	1	1	1	2	0	5
OG0008697	2	1	1	1	0	5
OG0008698	1	1	1	2	0	5
OG0008699	1	1	1	1	1	5
OG0008700	2	1	1	1	0	5
OG0008701	1	1	1	1	1	5
OG0008702	1	1	1	2	0	5
OG0008703	1	2	0	2	0	5
OG0008704	1	0	4	0	0	5
OG0008705	1	1	1	1	1	5
OG0008706	5	0	0	0	0	5
OG0008707	2	0	1	1	1	5
OG0008708	1	1	1	1	1	5
OG0008709	1	1	1	1	1	5
OG0008710	1	0	1	3	0	5
OG0008711	1	1	1	2	0	5
OG0008712	1	1	1	2	0	5
OG0008713	1	1	1	1	1	5
OG0008714	1	1	1	2	0	5
OG0008715	1	1	1	1	1	5
OG0008716	1	1	1	1	1	5
OG0008717	1	1	0	3	0	5
OG0008718	3	0	2	0	0	5
OG0008719	1	1	2	1	0	5
OG0008720	1	1	1	2	0	5
OG0008721	1	1	1	1	1	5
OG0008722	1	1	1	2	0	5
OG0008723	1	2	1	1	0	5
OG0008724	3	0	0	1	1	5
OG0008725	5	0	0	0	0	5
OG0008726	1	1	1	1	1	5
OG0008727	1	3	1	0	0	5
OG0008728	1	1	1	2	0	5
OG0008729	1	1	1	1	1	5
OG0008730	1	1	1	2	0	5
OG0008731	1	1	0	2	1	5
OG0008732	1	1	1	1	1	5
OG0008733	1	0	4	0	0	5
OG0008734	1	1	1	2	0	5
OG0008735	1	0	1	2	1	5
OG0008736	1	1	2	1	0	5
OG0008737	1	0	2	1	1	5
OG0008738	4	0	1	0	0	5
OG0008739	1	2	1	1	0	5
OG0008740	1	1	1	1	1	5
OG0008741	1	1	1	1	1	5
OG0008742	1	2	1	0	1	5
OG0008743	1	1	1	2	0	5
OG0008744	1	1	1	2	0	5
OG0008745	1	1	1	2	0	5
OG0008746	2	0	1	2	0	5
OG0008747	4	0	1	0	0	5
OG0008748	1	1	1	1	1	5
OG0008749	2	1	1	1	0	5
OG0008750	1	1	1	2	0	5
OG0008751	1	1	1	1	1	5
OG0008752	2	1	1	1	0	5
OG0008753	1	1	1	1	1	5
OG0008754	1	1	1	1	1	5
OG0008755	2	0	3	0	0	5
OG0008756	1	1	1	1	1	5
OG0008757	2	0	2	0	1	5
OG0008758	1	2	1	1	0	5
OG0008759	2	0	1	1	1	5
OG0008760	2	1	1	1	0	5
OG0008761	2	1	1	0	1	5
OG0008762	1	1	1	1	1	5
OG0008763	2	0	3	0	0	5
OG0008764	2	1	1	1	0	5
OG0008765	1	1	0	2	1	5
OG0008766	1	1	1	1	1	5
OG0008767	5	0	0	0	0	5
OG0008768	3	0	0	0	2	5
OG0008769	5	0	0	0	0	5
OG0008770	3	0	2	0	0	5
OG0008771	1	1	1	1	1	5
OG0008772	1	1	1	1	1	5
OG0008773	1	1	1	1	1	5
OG0008774	1	1	1	1	1	5
OG0008775	1	2	0	1	1	5
OG0008776	1	1	1	1	1	5
OG0008777	2	0	3	0	0	5
OG0008778	5	0	0	0	0	5
OG0008779	1	1	1	1	1	5
OG0008780	1	0	1	2	1	5
OG0008781	1	2	1	1	0	5
OG0008782	1	0	1	2	1	5
OG0008783	3	0	0	2	0	5
OG0008784	1	0	2	1	1	5
OG0008785	3	0	1	0	1	5
OG0008786	1	1	1	1	1	5
OG0008787	4	0	1	0	0	5
OG0008788	2	0	3	0	0	5
OG0008789	1	2	0	2	0	5
OG0008790	1	1	1	2	0	5
OG0008791	1	1	1	1	1	5
OG0008792	1	1	1	1	1	5
OG0008793	1	0	0	4	0	5
OG0008794	1	1	2	1	0	5
OG0008795	1	1	1	1	1	5
OG0008796	1	1	0	2	1	5
OG0008797	1	1	0	2	1	5
OG0008798	1	0	4	0	0	5
OG0008799	1	1	1	1	1	5
OG0008800	1	1	0	2	1	5
OG0008801	1	1	1	1	1	5
OG0008802	1	0	1	2	1	5
OG0008803	1	1	2	1	0	5
OG0008804	1	1	1	1	1	5
OG0008805	1	1	1	2	0	5
OG0008806	1	0	1	3	0	5
OG0008807	1	1	1	2	0	5
OG0008808	1	1	1	1	1	5
OG0008809	1	1	1	1	1	5
OG0008810	1	1	1	1	1	5
OG0008811	1	1	2	1	0	5
OG0008812	1	0	3	0	1	5
OG0008813	0	2	0	3	0	5
OG0008814	0	2	0	3	0	5
OG0008815	0	3	0	2	0	5
OG0008816	0	1	2	1	1	5
OG0008817	0	4	0	1	0	5
OG0008818	0	1	0	4	0	5
OG0008819	0	3	0	2	0	5
OG0008820	0	1	0	1	3	5
OG0008821	0	5	0	0	0	5
OG0008822	0	3	1	1	0	5
OG0008823	0	1	1	3	0	5
OG0008824	0	3	0	2	0	5
OG0008825	0	1	0	4	0	5
OG0008826	0	1	0	4	0	5
OG0008827	0	3	0	2	0	5
OG0008828	0	1	1	2	1	5
OG0008829	0	2	1	1	1	5
OG0008830	0	3	1	1	0	5
OG0008831	0	4	0	1	0	5
OG0008832	0	3	1	1	0	5
OG0008833	0	1	0	4	0	5
OG0008834	0	1	1	3	0	5
OG0008835	0	3	1	1	0	5
OG0008836	0	1	2	2	0	5
OG0008837	0	5	0	0	0	5
OG0008838	0	1	1	3	0	5
OG0008839	0	4	1	0	0	5
OG0008840	0	4	0	1	0	5
OG0008841	0	2	0	3	0	5
OG0008842	0	1	0	4	0	5
OG0008843	0	3	0	2	0	5
OG0008844	0	3	0	2	0	5
OG0008845	0	4	0	1	0	5
OG0008846	0	3	1	1	0	5
OG0008847	0	3	0	2	0	5
OG0008848	0	1	3	1	0	5
OG0008849	0	2	1	2	0	5
OG0008850	0	1	0	3	1	5
OG0008851	0	1	0	4	0	5
OG0008852	0	4	0	1	0	5
OG0008853	0	1	1	2	1	5
OG0008854	0	2	0	3	0	5
OG0008855	0	2	0	3	0	5
OG0008856	0	1	1	3	0	5
OG0008857	0	1	4	0	0	5
OG0008858	0	3	0	1	1	5
OG0008859	0	2	2	1	0	5
OG0008860	0	1	1	3	0	5
OG0008861	0	4	0	1	0	5
OG0008862	0	4	0	0	1	5
OG0008863	0	2	1	2	0	5
OG0008864	0	4	0	1	0	5
OG0008865	0	2	1	2	0	5
OG0008866	0	3	0	2	0	5
OG0008867	0	4	0	1	0	5
OG0008868	0	3	0	2	0	5
OG0008869	0	1	1	3	0	5
OG0008870	0	1	1	3	0	5
OG0008871	0	1	0	4	0	5
OG0008872	0	4	0	1	0	5
OG0008873	0	2	2	0	1	5
OG0008874	0	2	2	1	0	5
OG0008875	0	2	0	3	0	5
OG0008876	0	2	2	1	0	5
OG0008877	0	2	1	1	1	5
OG0008878	0	4	0	1	0	5
OG0008879	0	3	0	2	0	5
OG0008880	0	1	1	2	1	5
OG0008881	0	3	0	2	0	5
OG0008882	0	1	1	2	1	5
OG0008883	0	1	1	1	2	5
OG0008884	0	3	2	0	0	5
OG0008885	0	2	0	3	0	5
OG0008886	0	1	1	3	0	5
OG0008887	0	1	0	4	0	5
OG0008888	0	2	0	3	0	5
OG0008889	0	1	0	4	0	5
OG0008890	0	1	1	3	0	5
OG0008891	0	2	1	2	0	5
OG0008892	0	2	0	3	0	5
OG0008893	0	1	2	2	0	5
OG0008894	0	3	0	2	0	5
OG0008895	0	2	0	3	0	5
OG0008896	0	3	1	1	0	5
OG0008897	0	2	0	3	0	5
OG0008898	0	3	0	2	0	5
OG0008899	0	1	2	2	0	5
OG0008900	0	2	0	3	0	5
OG0008901	0	2	1	2	0	5
OG0008902	0	2	1	2	0	5
OG0008903	0	1	0	4	0	5
OG0008904	0	2	0	3	0	5
OG0008905	0	2	0	3	0	5
OG0008906	0	1	0	4	0	5
OG0008907	0	3	0	2	0	5
OG0008908	0	4	0	1	0	5
OG0008909	0	2	0	3	0	5
OG0008910	0	2	0	3	0	5
OG0008911	0	1	0	4	0	5
OG0008912	0	3	1	1	0	5
OG0008913	0	1	0	4	0	5
OG0008914	0	2	2	1	0	5
OG0008915	0	2	0	3	0	5
OG0008916	0	3	0	2	0	5
OG0008917	0	3	2	0	0	5
OG0008918	0	1	1	2	1	5
OG0008919	0	1	1	2	1	5
OG0008920	0	2	1	2	0	5
OG0008921	0	1	0	4	0	5
OG0008922	0	2	0	3	0	5
OG0008923	0	2	1	2	0	5
OG0008924	0	1	1	3	0	5
OG0008925	0	4	0	1	0	5
OG0008926	0	2	1	2	0	5
OG0008927	0	1	0	4	0	5
OG0008928	0	1	2	2	0	5
OG0008929	0	3	1	1	0	5
OG0008930	0	2	2	1	0	5
OG0008931	0	2	0	3	0	5
OG0008932	0	2	0	3	0	5
OG0008933	0	2	2	1	0	5
OG0008934	0	4	0	1	0	5
OG0008935	0	1	0	2	2	5
OG0008936	0	3	0	2	0	5
OG0008937	0	1	1	3	0	5
OG0008938	0	3	1	1	0	5
OG0008939	0	1	1	2	1	5
OG0008940	0	1	0	4	0	5
OG0008941	0	4	0	1	0	5
OG0008942	0	1	2	2	0	5
OG0008943	0	3	0	2	0	5
OG0008944	0	2	1	2	0	5
OG0008945	0	3	0	1	1	5
OG0008946	0	2	1	1	1	5
OG0008947	0	2	1	1	1	5
OG0008948	0	4	0	1	0	5
OG0008949	0	3	1	1	0	5
OG0008950	0	1	1	1	2	5
OG0008951	0	2	0	3	0	5
OG0008952	0	4	0	1	0	5
OG0008953	0	3	0	2	0	5
OG0008954	0	3	1	1	0	5
OG0008955	0	3	0	2	0	5
OG0008956	0	2	0	3	0	5
OG0008957	0	4	0	1	0	5
OG0008958	0	3	1	1	0	5
OG0008959	0	4	0	1	0	5
OG0008960	0	2	1	2	0	5
OG0008961	0	1	0	4	0	5
OG0008962	0	2	2	1	0	5
OG0008963	0	5	0	0	0	5
OG0008964	0	3	0	2	0	5
OG0008965	0	5	0	0	0	5
OG0008966	0	3	1	1	0	5
OG0008967	0	1	0	3	1	5
OG0008968	0	1	0	4	0	5
OG0008969	0	4	0	1	0	5
OG0008970	0	1	0	4	0	5
OG0008971	0	1	1	2	1	5
OG0008972	0	2	0	3	0	5
OG0008973	0	2	0	3	0	5
OG0008974	0	1	2	2	0	5
OG0008975	0	2	1	1	1	5
OG0008976	0	2	1	1	1	5
OG0008977	0	2	1	1	1	5
OG0008978	0	2	1	2	0	5
OG0008979	0	1	0	4	0	5
OG0008980	0	1	0	4	0	5
OG0008981	0	1	0	4	0	5
OG0008982	0	5	0	0	0	5
OG0008983	0	3	1	1	0	5
OG0008984	0	1	1	2	1	5
OG0008985	0	3	0	2	0	5
OG0008986	0	1	1	2	1	5
OG0008987	0	1	0	4	0	5
OG0008988	0	5	0	0	0	5
OG0008989	0	5	0	0	0	5
OG0008990	0	5	0	0	0	5
OG0008991	0	1	0	4	0	5
OG0008992	0	5	0	0	0	5
OG0008993	0	1	0	4	0	5
OG0008994	0	3	0	2	0	5
OG0008995	0	1	0	4	0	5
OG0008996	0	2	2	1	0	5
OG0008997	0	3	0	2	0	5
OG0008998	0	1	0	4	0	5
OG0008999	0	3	0	2	0	5
OG0009000	0	2	0	3	0	5
OG0009001	0	3	1	1	0	5
OG0009002	0	2	0	3	0	5
OG0009003	0	1	0	4	0	5
OG0009004	0	5	0	0	0	5
OG0009005	0	2	1	2	0	5
OG0009006	0	3	0	2	0	5
OG0009007	0	5	0	0	0	5
OG0009008	0	2	0	3	0	5
OG0009009	0	1	0	4	0	5
OG0009010	0	2	0	3	0	5
OG0009011	0	1	1	1	2	5
OG0009012	0	1	2	2	0	5
OG0009013	0	1	0	4	0	5
OG0009014	0	1	0	4	0	5
OG0009015	0	2	1	2	0	5
OG0009016	0	3	0	2	0	5
OG0009017	0	4	0	1	0	5
OG0009018	0	1	0	4	0	5
OG0009019	0	2	2	1	0	5
OG0009020	0	1	1	3	0	5
OG0009021	0	2	2	1	0	5
OG0009022	0	1	1	3	0	5
OG0009023	0	3	0	2	0	5
OG0009024	0	2	1	1	1	5
OG0009025	0	4	0	1	0	5
OG0009026	0	3	2	0	0	5
OG0009027	0	1	1	2	1	5
OG0009028	0	2	0	3	0	5
OG0009029	0	1	0	4	0	5
OG0009030	0	2	1	1	1	5
OG0009031	0	2	1	1	1	5
OG0009032	0	1	0	4	0	5
OG0009033	0	1	0	4	0	5
OG0009034	0	3	0	2	0	5
OG0009035	0	1	1	2	1	5
OG0009036	0	5	0	0	0	5
OG0009037	0	1	0	4	0	5
OG0009038	0	1	1	2	1	5
OG0009039	0	3	0	2	0	5
OG0009040	0	1	0	4	0	5
OG0009041	0	2	0	2	1	5
OG0009042	0	2	0	3	0	5
OG0009043	0	1	0	4	0	5
OG0009044	0	2	0	3	0	5
OG0009045	0	4	0	1	0	5
OG0009046	0	3	1	1	0	5
OG0009047	0	2	1	2	0	5
OG0009048	0	1	3	1	0	5
OG0009049	0	3	2	0	0	5
OG0009050	0	2	0	3	0	5
OG0009051	0	2	1	1	1	5
OG0009052	0	3	0	2	0	5
OG0009053	0	1	2	1	1	5
OG0009054	0	1	2	0	2	5
OG0009055	0	1	0	4	0	5
OG0009056	0	2	1	2	0	5
OG0009057	0	1	1	3	0	5
OG0009058	0	1	1	3	0	5
OG0009059	0	2	0	3	0	5
OG0009060	0	1	0	4	0	5
OG0009061	0	1	0	4	0	5
OG0009062	0	2	0	3	0	5
OG0009063	0	2	0	2	1	5
OG0009064	0	1	1	2	1	5
OG0009065	0	1	0	4	0	5
OG0009066	0	1	0	4	0	5
OG0009067	0	1	1	3	0	5
OG0009068	0	2	0	3	0	5
OG0009069	0	2	0	3	0	5
OG0009070	0	1	2	1	1	5
OG0009071	0	2	1	1	1	5
OG0009072	0	2	1	1	1	5
OG0009073	0	2	1	2	0	5
OG0009074	0	2	0	3	0	5
OG0009075	0	4	0	1	0	5
OG0009076	0	3	1	1	0	5
OG0009077	0	2	0	3	0	5
OG0009078	0	3	1	1	0	5
OG0009079	0	3	1	0	1	5
OG0009080	0	3	1	0	1	5
OG0009081	0	1	0	1	3	5
OG0009082	0	1	1	3	0	5
OG0009083	0	1	0	4	0	5
OG0009084	0	1	1	3	0	5
OG0009085	0	1	0	0	4	5
OG0009086	0	1	1	3	0	5
OG0009087	0	1	0	4	0	5
OG0009088	0	3	0	2	0	5
OG0009089	0	1	2	1	1	5
OG0009090	0	1	0	4	0	5
OG0009091	0	1	1	2	1	5
OG0009092	0	5	0	0	0	5
OG0009093	0	4	1	0	0	5
OG0009094	0	1	0	4	0	5
OG0009095	0	1	1	3	0	5
OG0009096	0	1	1	2	1	5
OG0009097	0	1	1	2	1	5
OG0009098	0	1	2	1	1	5
OG0009099	0	1	1	2	1	5
OG0009100	0	1	0	4	0	5
OG0009101	0	1	0	4	0	5
OG0009102	0	1	1	3	0	5
OG0009103	0	1	1	2	1	5
OG0009104	0	1	3	1	0	5
OG0009105	0	1	1	1	2	5
OG0009106	0	1	0	4	0	5
OG0009107	0	1	1	3	0	5
OG0009108	0	1	2	2	0	5
OG0009109	0	1	1	2	1	5
OG0009110	0	1	0	4	0	5
OG0009111	0	1	0	4	0	5
OG0009112	0	1	1	2	1	5
OG0009113	0	1	1	2	1	5
OG0009114	0	1	0	4	0	5
OG0009115	0	3	0	1	1	5
OG0009116	0	1	1	3	0	5
OG0009117	0	1	0	4	0	5
OG0009118	0	1	1	2	1	5
OG0009119	0	1	1	2	1	5
OG0009120	0	1	0	4	0	5
OG0009121	0	2	1	1	1	5
OG0009122	0	1	1	3	0	5
OG0009123	0	1	0	2	2	5
OG0009124	0	2	0	3	0	5
OG0009125	0	0	1	4	0	5
OG0009126	0	0	3	1	1	5
OG0009127	0	0	1	4	0	5
OG0009128	0	0	4	0	1	5
OG0009129	0	0	5	0	0	5
OG0009130	0	0	5	0	0	5
OG0009131	0	0	2	0	3	5
OG0009132	0	0	5	0	0	5
OG0009133	0	0	4	1	0	5
OG0009134	0	0	2	2	1	5
OG0009135	0	0	1	3	1	5
OG0009136	0	0	2	0	3	5
OG0009137	0	0	4	1	0	5
OG0009138	0	0	2	3	0	5
OG0009139	0	0	3	0	2	5
OG0009140	0	0	4	0	1	5
OG0009141	0	0	2	3	0	5
OG0009142	0	0	1	4	0	5
OG0009143	0	0	1	4	0	5
OG0009144	0	0	4	0	1	5
OG0009145	0	0	1	4	0	5
OG0009146	0	0	2	1	2	5
OG0009147	0	0	2	3	0	5
OG0009148	0	0	5	0	0	5
OG0009149	0	0	2	3	0	5
OG0009150	0	0	4	1	0	5
OG0009151	0	0	4	0	1	5
OG0009152	0	0	4	1	0	5
OG0009153	0	0	3	1	1	5
OG0009154	0	0	1	4	0	5
OG0009155	0	0	1	4	0	5
OG0009156	0	0	4	0	1	5
OG0009157	0	0	1	4	0	5
OG0009158	0	0	1	4	0	5
OG0009159	0	0	2	3	0	5
OG0009160	0	0	1	3	1	5
OG0009161	0	0	3	2	0	5
OG0009162	0	0	3	1	1	5
OG0009163	0	0	4	1	0	5
OG0009164	0	0	4	0	1	5
OG0009165	0	0	2	3	0	5
OG0009166	0	0	4	1	0	5
OG0009167	0	0	4	0	1	5
OG0009168	0	0	5	0	0	5
OG0009169	0	0	1	4	0	5
OG0009170	0	0	2	3	0	5
OG0009171	0	0	1	3	1	5
OG0009172	0	0	2	3	0	5
OG0009173	0	0	4	0	1	5
OG0009174	0	0	5	0	0	5
OG0009175	0	0	1	0	4	5
OG0009176	0	0	5	0	0	5
OG0009177	0	0	3	0	2	5
OG0009178	0	0	4	0	1	5
OG0009179	0	0	1	4	0	5
OG0009180	0	0	5	0	0	5
OG0009181	0	0	4	1	0	5
OG0009182	0	0	2	3	0	5
OG0009183	0	0	4	0	1	5
OG0009184	0	0	3	0	2	5
OG0009185	0	0	5	0	0	5
OG0009186	0	0	1	3	1	5
OG0009187	0	0	4	1	0	5
OG0009188	0	0	5	0	0	5
OG0009189	0	0	1	3	1	5
OG0009190	0	0	1	0	4	5
OG0009191	0	0	5	0	0	5
OG0009192	0	0	1	0	4	5
OG0009193	0	0	5	0	0	5
OG0009194	0	0	5	0	0	5
OG0009195	0	0	1	4	0	5
OG0009196	0	0	5	0	0	5
OG0009197	0	0	1	2	2	5
OG0009198	0	0	2	3	0	5
OG0009199	0	0	4	1	0	5
OG0009200	0	0	2	2	1	5
OG0009201	0	0	1	3	1	5
OG0009202	0	0	1	0	4	5
OG0009203	0	0	2	3	0	5
OG0009204	0	0	4	0	1	5
OG0009205	0	0	4	0	1	5
OG0009206	0	0	2	2	1	5
OG0009207	0	0	2	3	0	5
OG0009208	0	0	5	0	0	5
OG0009209	0	0	2	0	3	5
OG0009210	0	0	5	0	0	5
OG0009211	0	0	1	3	1	5
OG0009212	0	0	2	2	1	5
OG0009213	0	0	2	3	0	5
OG0009214	0	0	1	3	1	5
OG0009215	0	0	2	2	1	5
OG0009216	0	0	3	1	1	5
OG0009217	0	0	1	0	4	5
OG0009218	0	0	2	0	3	5
OG0009219	0	0	2	3	0	5
OG0009220	0	0	5	0	0	5
OG0009221	0	0	5	0	0	5
OG0009222	0	0	1	0	4	5
OG0009223	0	0	2	0	3	5
OG0009224	0	0	0	4	1	5
OG0009225	0	0	0	5	0	5
OG0009226	0	0	0	5	0	5
OG0009227	0	0	0	5	0	5
OG0009228	0	0	0	5	0	5
OG0009229	0	0	0	5	0	5
OG0009230	0	0	0	1	4	5
OG0009231	0	0	0	4	1	5
OG0009232	0	0	0	5	0	5
OG0009233	0	0	0	5	0	5
OG0009234	0	0	0	4	1	5
OG0009235	0	0	0	5	0	5
OG0009236	0	0	0	5	0	5
OG0009237	0	0	0	5	0	5
OG0009238	0	0	0	5	0	5
OG0009239	0	0	0	5	0	5
OG0009240	0	0	0	5	0	5
OG0009241	0	0	0	5	0	5
OG0009242	0	0	0	5	0	5
OG0009243	0	0	0	5	0	5
OG0009244	0	0	0	5	0	5
OG0009245	0	0	0	5	0	5
OG0009246	0	0	0	5	0	5
OG0009247	0	0	0	5	0	5
OG0009248	0	0	0	5	0	5
OG0009249	0	0	0	5	0	5
OG0009250	0	0	0	5	0	5
OG0009251	0	0	0	5	0	5
OG0009252	0	0	0	5	0	5
OG0009253	0	0	0	5	0	5
OG0009254	0	0	0	5	0	5
OG0009255	0	0	0	4	1	5
OG0009256	0	0	0	5	0	5
OG0009257	0	0	0	5	0	5
OG0009258	0	0	0	5	0	5
OG0009259	0	0	0	5	0	5
OG0009260	0	0	0	3	2	5
OG0009261	0	0	0	5	0	5
OG0009262	0	0	0	5	0	5
OG0009263	0	0	0	5	0	5
OG0009264	0	0	0	5	0	5
OG0009265	0	0	0	5	0	5
OG0009266	0	0	0	5	0	5
OG0009267	0	0	0	3	2	5
OG0009268	0	0	0	5	0	5
OG0009269	0	0	0	1	4	5
OG0009270	0	0	0	0	5	5
OG0009271	0	0	0	0	5	5
OG0009272	3	0	0	1	0	4
OG0009273	1	1	1	1	0	4
OG0009274	1	0	1	1	1	4
OG0009275	2	1	0	1	0	4
OG0009276	1	1	1	1	0	4
OG0009277	1	0	2	0	1	4
OG0009278	1	2	0	1	0	4
OG0009279	1	1	1	1	0	4
OG0009280	2	0	2	0	0	4
OG0009281	2	0	2	0	0	4
OG0009282	3	0	0	1	0	4
OG0009283	1	0	1	1	1	4
OG0009284	1	1	1	1	0	4
OG0009285	3	1	0	0	0	4
OG0009286	1	0	1	2	0	4
OG0009287	1	0	1	1	1	4
OG0009288	3	0	1	0	0	4
OG0009289	4	0	0	0	0	4
OG0009290	1	1	1	1	0	4
OG0009291	1	0	2	0	1	4
OG0009292	1	1	1	1	0	4
OG0009293	1	2	1	0	0	4
OG0009294	1	0	1	1	1	4
OG0009295	3	0	0	1	0	4
OG0009296	3	0	1	0	0	4
OG0009297	1	1	1	1	0	4
OG0009298	1	1	1	1	0	4
OG0009299	1	0	1	2	0	4
OG0009300	1	0	3	0	0	4
OG0009301	1	1	1	1	0	4
OG0009302	1	1	0	2	0	4
OG0009303	1	0	3	0	0	4
OG0009304	1	0	3	0	0	4
OG0009305	1	1	1	1	0	4
OG0009306	1	0	2	1	0	4
OG0009307	4	0	0	0	0	4
OG0009308	2	0	2	0	0	4
OG0009309	1	1	1	1	0	4
OG0009310	1	2	0	1	0	4
OG0009311	1	1	1	1	0	4
OG0009312	4	0	0	0	0	4
OG0009313	1	0	3	0	0	4
OG0009314	1	1	1	1	0	4
OG0009315	1	1	1	1	0	4
OG0009316	1	1	0	2	0	4
OG0009317	1	0	3	0	0	4
OG0009318	1	1	1	1	0	4
OG0009319	3	0	1	0	0	4
OG0009320	1	1	1	1	0	4
OG0009321	1	0	1	1	1	4
OG0009322	1	1	1	1	0	4
OG0009323	1	1	1	1	0	4
OG0009324	4	0	0	0	0	4
OG0009325	1	1	1	1	0	4
OG0009326	1	0	1	1	1	4
OG0009327	1	0	1	1	1	4
OG0009328	1	1	2	0	0	4
OG0009329	1	0	1	2	0	4
OG0009330	3	0	1	0	0	4
OG0009331	1	0	1	2	0	4
OG0009332	1	1	0	2	0	4
OG0009333	1	1	1	1	0	4
OG0009334	1	1	0	2	0	4
OG0009335	1	0	1	1	1	4
OG0009336	1	1	1	1	0	4
OG0009337	1	1	1	1	0	4
OG0009338	1	0	1	1	1	4
OG0009339	2	0	1	0	1	4
OG0009340	1	1	1	1	0	4
OG0009341	1	0	2	0	1	4
OG0009342	1	1	1	1	0	4
OG0009343	2	1	0	1	0	4
OG0009344	1	0	1	1	1	4
OG0009345	1	0	1	2	0	4
OG0009346	2	0	1	0	1	4
OG0009347	1	1	1	1	0	4
OG0009348	1	1	1	1	0	4
OG0009349	1	1	1	1	0	4
OG0009350	1	1	1	1	0	4
OG0009351	1	1	1	1	0	4
OG0009352	3	0	1	0	0	4
OG0009353	1	0	1	1	1	4
OG0009354	1	1	1	1	0	4
OG0009355	1	0	1	1	1	4
OG0009356	1	1	1	1	0	4
OG0009357	1	1	1	1	0	4
OG0009358	2	0	1	0	1	4
OG0009359	1	1	1	1	0	4
OG0009360	1	0	3	0	0	4
OG0009361	4	0	0	0	0	4
OG0009362	1	0	0	2	1	4
OG0009363	1	1	1	1	0	4
OG0009364	1	0	1	1	1	4
OG0009365	1	1	1	1	0	4
OG0009366	1	1	1	1	0	4
OG0009367	4	0	0	0	0	4
OG0009368	1	1	1	1	0	4
OG0009369	1	1	1	1	0	4
OG0009370	1	0	2	1	0	4
OG0009371	1	0	0	0	3	4
OG0009372	1	0	3	0	0	4
OG0009373	1	0	1	1	1	4
OG0009374	1	0	1	1	1	4
OG0009375	4	0	0	0	0	4
OG0009376	1	1	1	1	0	4
OG0009377	2	0	0	0	2	4
OG0009378	1	0	1	2	0	4
OG0009379	1	1	1	1	0	4
OG0009380	1	0	1	2	0	4
OG0009381	1	0	2	0	1	4
OG0009382	2	0	2	0	0	4
OG0009383	1	1	1	1	0	4
OG0009384	1	1	0	2	0	4
OG0009385	1	1	1	1	0	4
OG0009386	1	1	1	1	0	4
OG0009387	1	1	1	1	0	4
OG0009388	1	0	3	0	0	4
OG0009389	1	1	1	1	0	4
OG0009390	1	0	1	2	0	4
OG0009391	1	1	1	1	0	4
OG0009392	1	1	1	1	0	4
OG0009393	1	0	1	1	1	4
OG0009394	1	1	0	2	0	4
OG0009395	2	0	2	0	0	4
OG0009396	1	1	1	1	0	4
OG0009397	1	1	1	1	0	4
OG0009398	1	0	1	1	1	4
OG0009399	1	1	1	1	0	4
OG0009400	2	1	0	1	0	4
OG0009401	1	1	1	1	0	4
OG0009402	1	1	1	1	0	4
OG0009403	1	0	1	1	1	4
OG0009404	2	0	0	2	0	4
OG0009405	2	0	1	0	1	4
OG0009406	1	1	1	1	0	4
OG0009407	2	0	1	1	0	4
OG0009408	1	1	1	1	0	4
OG0009409	3	0	1	0	0	4
OG0009410	1	1	0	2	0	4
OG0009411	1	0	3	0	0	4
OG0009412	1	0	1	1	1	4
OG0009413	1	1	1	1	0	4
OG0009414	1	0	0	2	1	4
OG0009415	1	2	0	1	0	4
OG0009416	1	0	1	2	0	4
OG0009417	1	1	1	1	0	4
OG0009418	1	1	2	0	0	4
OG0009419	3	0	1	0	0	4
OG0009420	1	1	1	1	0	4
OG0009421	1	1	1	1	0	4
OG0009422	2	0	1	1	0	4
OG0009423	1	1	1	1	0	4
OG0009424	1	1	1	0	1	4
OG0009425	1	1	1	1	0	4
OG0009426	1	1	1	1	0	4
OG0009427	1	0	1	1	1	4
OG0009428	3	0	1	0	0	4
OG0009429	1	1	1	1	0	4
OG0009430	1	1	1	1	0	4
OG0009431	3	0	1	0	0	4
OG0009432	1	0	2	0	1	4
OG0009433	4	0	0	0	0	4
OG0009434	4	0	0	0	0	4
OG0009435	1	0	1	2	0	4
OG0009436	2	0	1	1	0	4
OG0009437	4	0	0	0	0	4
OG0009438	1	1	1	1	0	4
OG0009439	3	0	1	0	0	4
OG0009440	1	0	1	1	1	4
OG0009441	1	1	0	2	0	4
OG0009442	4	0	0	0	0	4
OG0009443	2	1	0	0	1	4
OG0009444	1	1	1	1	0	4
OG0009445	1	1	1	1	0	4
OG0009446	4	0	0	0	0	4
OG0009447	1	1	1	1	0	4
OG0009448	1	1	0	2	0	4
OG0009449	1	0	0	2	1	4
OG0009450	1	1	1	1	0	4
OG0009451	1	1	1	1	0	4
OG0009452	4	0	0	0	0	4
OG0009453	1	0	2	1	0	4
OG0009454	1	0	1	1	1	4
OG0009455	1	0	1	1	1	4
OG0009456	2	0	2	0	0	4
OG0009457	2	0	2	0	0	4
OG0009458	4	0	0	0	0	4
OG0009459	1	1	1	0	1	4
OG0009460	1	1	2	0	0	4
OG0009461	4	0	0	0	0	4
OG0009462	3	0	1	0	0	4
OG0009463	1	0	0	0	3	4
OG0009464	3	0	1	0	0	4
OG0009465	1	1	1	1	0	4
OG0009466	2	0	2	0	0	4
OG0009467	1	0	3	0	0	4
OG0009468	1	0	2	1	0	4
OG0009469	1	0	0	3	0	4
OG0009470	1	0	0	3	0	4
OG0009471	3	0	0	1	0	4
OG0009472	1	0	0	3	0	4
OG0009473	2	0	0	2	0	4
OG0009474	1	2	1	0	0	4
OG0009475	1	0	1	1	1	4
OG0009476	4	0	0	0	0	4
OG0009477	4	0	0	0	0	4
OG0009478	1	0	1	2	0	4
OG0009479	3	0	0	0	1	4
OG0009480	4	0	0	0	0	4
OG0009481	3	0	1	0	0	4
OG0009482	1	1	1	1	0	4
OG0009483	2	0	2	0	0	4
OG0009484	3	0	0	1	0	4
OG0009485	1	0	1	2	0	4
OG0009486	1	1	0	2	0	4
OG0009487	4	0	0	0	0	4
OG0009488	3	0	1	0	0	4
OG0009489	1	1	0	2	0	4
OG0009490	0	1	0	3	0	4
OG0009491	0	2	0	2	0	4
OG0009492	0	1	1	2	0	4
OG0009493	0	3	0	1	0	4
OG0009494	0	1	1	2	0	4
OG0009495	0	1	1	2	0	4
OG0009496	0	2	0	2	0	4
OG0009497	0	1	1	1	1	4
OG0009498	0	1	0	3	0	4
OG0009499	0	2	0	2	0	4
OG0009500	0	1	1	1	1	4
OG0009501	0	1	1	2	0	4
OG0009502	0	1	0	3	0	4
OG0009503	0	1	1	1	1	4
OG0009504	0	2	0	2	0	4
OG0009505	0	2	1	1	0	4
OG0009506	0	1	1	2	0	4
OG0009507	0	1	0	3	0	4
OG0009508	0	1	1	1	1	4
OG0009509	0	2	0	2	0	4
OG0009510	0	2	0	2	0	4
OG0009511	0	2	1	1	0	4
OG0009512	0	1	1	2	0	4
OG0009513	0	1	1	1	1	4
OG0009514	0	1	1	2	0	4
OG0009515	0	3	0	1	0	4
OG0009516	0	1	2	1	0	4
OG0009517	0	2	0	2	0	4
OG0009518	0	3	0	1	0	4
OG0009519	0	3	1	0	0	4
OG0009520	0	2	0	2	0	4
OG0009521	0	2	0	2	0	4
OG0009522	0	2	0	2	0	4
OG0009523	0	1	0	3	0	4
OG0009524	0	1	2	1	0	4
OG0009525	0	2	0	2	0	4
OG0009526	0	2	1	1	0	4
OG0009527	0	2	0	2	0	4
OG0009528	0	1	3	0	0	4
OG0009529	0	2	0	2	0	4
OG0009530	0	4	0	0	0	4
OG0009531	0	1	0	3	0	4
OG0009532	0	1	0	3	0	4
OG0009533	0	2	0	2	0	4
OG0009534	0	1	1	1	1	4
OG0009535	0	3	0	1	0	4
OG0009536	0	1	1	2	0	4
OG0009537	0	1	0	3	0	4
OG0009538	0	1	1	2	0	4
OG0009539	0	2	1	1	0	4
OG0009540	0	3	0	1	0	4
OG0009541	0	1	1	1	1	4
OG0009542	0	2	0	2	0	4
OG0009543	0	3	0	1	0	4
OG0009544	0	2	1	1	0	4
OG0009545	0	2	1	1	0	4
OG0009546	0	1	2	1	0	4
OG0009547	0	3	1	0	0	4
OG0009548	0	2	0	2	0	4
OG0009549	0	2	0	2	0	4
OG0009550	0	2	0	2	0	4
OG0009551	0	1	0	3	0	4
OG0009552	0	2	0	2	0	4
OG0009553	0	3	0	1	0	4
OG0009554	0	1	0	3	0	4
OG0009555	0	1	1	2	0	4
OG0009556	0	1	1	1	1	4
OG0009557	0	1	1	1	1	4
OG0009558	0	2	0	1	1	4
OG0009559	0	1	0	3	0	4
OG0009560	0	1	2	1	0	4
OG0009561	0	1	0	1	2	4
OG0009562	0	1	0	3	0	4
OG0009563	0	1	1	1	1	4
OG0009564	0	2	1	1	0	4
OG0009565	0	2	1	1	0	4
OG0009566	0	2	0	2	0	4
OG0009567	0	1	1	1	1	4
OG0009568	0	2	1	1	0	4
OG0009569	0	1	1	1	1	4
OG0009570	0	1	0	3	0	4
OG0009571	0	1	1	1	1	4
OG0009572	0	1	0	3	0	4
OG0009573	0	1	1	1	1	4
OG0009574	0	2	0	1	1	4
OG0009575	0	1	0	3	0	4
OG0009576	0	2	0	2	0	4
OG0009577	0	1	1	2	0	4
OG0009578	0	2	0	2	0	4
OG0009579	0	3	0	1	0	4
OG0009580	0	1	0	3	0	4
OG0009581	0	1	1	1	1	4
OG0009582	0	1	0	3	0	4
OG0009583	0	1	2	1	0	4
OG0009584	0	2	0	1	1	4
OG0009585	0	2	1	1	0	4
OG0009586	0	1	0	3	0	4
OG0009587	0	2	0	2	0	4
OG0009588	0	1	1	2	0	4
OG0009589	0	1	1	2	0	4
OG0009590	0	2	0	2	0	4
OG0009591	0	1	1	2	0	4
OG0009592	0	1	0	3	0	4
OG0009593	0	4	0	0	0	4
OG0009594	0	2	0	2	0	4
OG0009595	0	1	1	2	0	4
OG0009596	0	2	0	2	0	4
OG0009597	0	1	0	3	0	4
OG0009598	0	2	0	1	1	4
OG0009599	0	2	0	2	0	4
OG0009600	0	3	0	1	0	4
OG0009601	0	3	0	1	0	4
OG0009602	0	1	1	2	0	4
OG0009603	0	2	0	2	0	4
OG0009604	0	3	0	1	0	4
OG0009605	0	3	0	1	0	4
OG0009606	0	3	0	1	0	4
OG0009607	0	2	0	2	0	4
OG0009608	0	1	0	3	0	4
OG0009609	0	1	0	3	0	4
OG0009610	0	1	0	3	0	4
OG0009611	0	2	0	2	0	4
OG0009612	0	2	0	2	0	4
OG0009613	0	1	0	3	0	4
OG0009614	0	1	0	3	0	4
OG0009615	0	1	0	3	0	4
OG0009616	0	1	1	1	1	4
OG0009617	0	1	2	1	0	4
OG0009618	0	3	0	0	1	4
OG0009619	0	1	0	3	0	4
OG0009620	0	1	1	1	1	4
OG0009621	0	1	1	1	1	4
OG0009622	0	1	0	3	0	4
OG0009623	0	1	1	1	1	4
OG0009624	0	2	1	1	0	4
OG0009625	0	3	0	1	0	4
OG0009626	0	4	0	0	0	4
OG0009627	0	3	1	0	0	4
OG0009628	0	1	0	3	0	4
OG0009629	0	4	0	0	0	4
OG0009630	0	1	0	3	0	4
OG0009631	0	1	0	3	0	4
OG0009632	0	1	0	3	0	4
OG0009633	0	4	0	0	0	4
OG0009634	0	1	1	2	0	4
OG0009635	0	1	3	0	0	4
OG0009636	0	2	0	2	0	4
OG0009637	0	3	0	1	0	4
OG0009638	0	2	0	2	0	4
OG0009639	0	1	2	1	0	4
OG0009640	0	2	0	2	0	4
OG0009641	0	2	0	2	0	4
OG0009642	0	1	1	2	0	4
OG0009643	0	1	2	1	0	4
OG0009644	0	1	0	3	0	4
OG0009645	0	1	0	3	0	4
OG0009646	0	2	0	2	0	4
OG0009647	0	1	0	3	0	4
OG0009648	0	2	0	1	1	4
OG0009649	0	1	1	2	0	4
OG0009650	0	2	2	0	0	4
OG0009651	0	2	0	2	0	4
OG0009652	0	1	0	3	0	4
OG0009653	0	3	1	0	0	4
OG0009654	0	1	2	1	0	4
OG0009655	0	1	0	3	0	4
OG0009656	0	3	0	0	1	4
OG0009657	0	1	1	1	1	4
OG0009658	0	2	0	2	0	4
OG0009659	0	2	0	2	0	4
OG0009660	0	2	0	2	0	4
OG0009661	0	3	0	1	0	4
OG0009662	0	2	0	2	0	4
OG0009663	0	2	1	1	0	4
OG0009664	0	1	1	2	0	4
OG0009665	0	2	0	2	0	4
OG0009666	0	1	1	0	2	4
OG0009667	0	3	0	1	0	4
OG0009668	0	4	0	0	0	4
OG0009669	0	1	1	2	0	4
OG0009670	0	1	0	3	0	4
OG0009671	0	4	0	0	0	4
OG0009672	0	2	0	2	0	4
OG0009673	0	1	2	1	0	4
OG0009674	0	4	0	0	0	4
OG0009675	0	3	0	1	0	4
OG0009676	0	4	0	0	0	4
OG0009677	0	3	0	1	0	4
OG0009678	0	3	0	1	0	4
OG0009679	0	1	1	2	0	4
OG0009680	0	1	0	3	0	4
OG0009681	0	2	0	2	0	4
OG0009682	0	2	0	2	0	4
OG0009683	0	1	0	3	0	4
OG0009684	0	2	0	2	0	4
OG0009685	0	2	0	2	0	4
OG0009686	0	2	0	2	0	4
OG0009687	0	2	1	1	0	4
OG0009688	0	1	1	1	1	4
OG0009689	0	2	1	1	0	4
OG0009690	0	2	1	1	0	4
OG0009691	0	1	0	2	1	4
OG0009692	0	3	0	1	0	4
OG0009693	0	2	0	0	2	4
OG0009694	0	2	1	1	0	4
OG0009695	0	1	2	1	0	4
OG0009696	0	3	0	1	0	4
OG0009697	0	1	0	3	0	4
OG0009698	0	2	0	2	0	4
OG0009699	0	1	0	3	0	4
OG0009700	0	1	0	3	0	4
OG0009701	0	1	0	3	0	4
OG0009702	0	1	0	1	2	4
OG0009703	0	1	2	1	0	4
OG0009704	0	4	0	0	0	4
OG0009705	0	2	1	1	0	4
OG0009706	0	1	1	1	1	4
OG0009707	0	3	1	0	0	4
OG0009708	0	2	1	1	0	4
OG0009709	0	2	2	0	0	4
OG0009710	0	4	0	0	0	4
OG0009711	0	1	3	0	0	4
OG0009712	0	2	0	0	2	4
OG0009713	0	1	0	3	0	4
OG0009714	0	1	2	1	0	4
OG0009715	0	2	1	1	0	4
OG0009716	0	1	2	1	0	4
OG0009717	0	3	0	1	0	4
OG0009718	0	1	2	1	0	4
OG0009719	0	1	0	0	3	4
OG0009720	0	2	0	2	0	4
OG0009721	0	1	1	1	1	4
OG0009722	0	2	0	2	0	4
OG0009723	0	4	0	0	0	4
OG0009724	0	3	0	1	0	4
OG0009725	0	3	0	1	0	4
OG0009726	0	4	0	0	0	4
OG0009727	0	1	1	2	0	4
OG0009728	0	1	0	3	0	4
OG0009729	0	1	0	3	0	4
OG0009730	0	3	0	0	1	4
OG0009731	0	2	0	0	2	4
OG0009732	0	1	1	2	0	4
OG0009733	0	3	0	1	0	4
OG0009734	0	2	0	2	0	4
OG0009735	0	2	0	2	0	4
OG0009736	0	1	0	3	0	4
OG0009737	0	2	1	1	0	4
OG0009738	0	2	0	2	0	4
OG0009739	0	2	0	2	0	4
OG0009740	0	3	0	1	0	4
OG0009741	0	1	1	1	1	4
OG0009742	0	1	1	2	0	4
OG0009743	0	1	1	2	0	4
OG0009744	0	2	1	1	0	4
OG0009745	0	4	0	0	0	4
OG0009746	0	1	3	0	0	4
OG0009747	0	1	1	2	0	4
OG0009748	0	3	0	1	0	4
OG0009749	0	1	0	2	1	4
OG0009750	0	1	0	3	0	4
OG0009751	0	2	0	2	0	4
OG0009752	0	2	1	1	0	4
OG0009753	0	1	0	3	0	4
OG0009754	0	4	0	0	0	4
OG0009755	0	1	0	3	0	4
OG0009756	0	1	0	3	0	4
OG0009757	0	1	0	2	1	4
OG0009758	0	2	0	0	2	4
OG0009759	0	2	0	2	0	4
OG0009760	0	2	0	2	0	4
OG0009761	0	3	0	1	0	4
OG0009762	0	2	0	2	0	4
OG0009763	0	1	0	2	1	4
OG0009764	0	2	0	2	0	4
OG0009765	0	2	0	2	0	4
OG0009766	0	1	0	3	0	4
OG0009767	0	1	0	3	0	4
OG0009768	0	1	0	3	0	4
OG0009769	0	1	2	1	0	4
OG0009770	0	2	1	1	0	4
OG0009771	0	1	0	3	0	4
OG0009772	0	1	0	3	0	4
OG0009773	0	1	1	2	0	4
OG0009774	0	1	0	1	2	4
OG0009775	0	2	1	1	0	4
OG0009776	0	4	0	0	0	4
OG0009777	0	2	0	2	0	4
OG0009778	0	4	0	0	0	4
OG0009779	0	1	0	3	0	4
OG0009780	0	1	1	2	0	4
OG0009781	0	2	0	1	1	4
OG0009782	0	2	0	2	0	4
OG0009783	0	1	1	2	0	4
OG0009784	0	1	0	3	0	4
OG0009785	0	1	1	2	0	4
OG0009786	0	1	1	2	0	4
OG0009787	0	1	0	3	0	4
OG0009788	0	1	0	3	0	4
OG0009789	0	1	3	0	0	4
OG0009790	0	3	1	0	0	4
OG0009791	0	2	0	2	0	4
OG0009792	0	1	0	3	0	4
OG0009793	0	1	0	1	2	4
OG0009794	0	2	0	2	0	4
OG0009795	0	1	0	3	0	4
OG0009796	0	1	0	3	0	4
OG0009797	0	1	1	1	1	4
OG0009798	0	1	0	3	0	4
OG0009799	0	1	1	2	0	4
OG0009800	0	2	0	2	0	4
OG0009801	0	1	0	3	0	4
OG0009802	0	1	0	3	0	4
OG0009803	0	1	1	2	0	4
OG0009804	0	1	1	2	0	4
OG0009805	0	1	1	2	0	4
OG0009806	0	1	1	1	1	4
OG0009807	0	1	0	0	3	4
OG0009808	0	1	0	3	0	4
OG0009809	0	1	0	3	0	4
OG0009810	0	1	1	1	1	4
OG0009811	0	1	1	1	1	4
OG0009812	0	1	0	3	0	4
OG0009813	0	1	0	3	0	4
OG0009814	0	1	1	1	1	4
OG0009815	0	1	0	3	0	4
OG0009816	0	2	0	2	0	4
OG0009817	0	1	1	1	1	4
OG0009818	0	1	0	3	0	4
OG0009819	0	1	2	1	0	4
OG0009820	0	1	0	3	0	4
OG0009821	0	1	1	1	1	4
OG0009822	0	1	1	1	1	4
OG0009823	0	1	0	3	0	4
OG0009824	0	2	0	2	0	4
OG0009825	0	1	0	3	0	4
OG0009826	0	1	1	1	1	4
OG0009827	0	1	1	2	0	4
OG0009828	0	1	1	2	0	4
OG0009829	0	1	0	3	0	4
OG0009830	0	1	1	2	0	4
OG0009831	0	1	1	1	1	4
OG0009832	0	1	1	2	0	4
OG0009833	0	0	3	0	1	4
OG0009834	0	0	4	0	0	4
OG0009835	0	0	3	0	1	4
OG0009836	0	0	1	3	0	4
OG0009837	0	0	4	0	0	4
OG0009838	0	0	1	2	1	4
OG0009839	0	0	4	0	0	4
OG0009840	0	0	2	2	0	4
OG0009841	0	0	2	0	2	4
OG0009842	0	0	3	1	0	4
OG0009843	0	0	4	0	0	4
OG0009844	0	0	1	0	3	4
OG0009845	0	0	2	1	1	4
OG0009846	0	0	2	2	0	4
OG0009847	0	0	3	0	1	4
OG0009848	0	0	3	0	1	4
OG0009849	0	0	1	0	3	4
OG0009850	0	0	3	0	1	4
OG0009851	0	0	3	0	1	4
OG0009852	0	0	2	1	1	4
OG0009853	0	0	2	2	0	4
OG0009854	0	0	1	2	1	4
OG0009855	0	0	3	1	0	4
OG0009856	0	0	4	0	0	4
OG0009857	0	0	3	0	1	4
OG0009858	0	0	4	0	0	4
OG0009859	0	0	4	0	0	4
OG0009860	0	0	2	1	1	4
OG0009861	0	0	2	2	0	4
OG0009862	0	0	2	2	0	4
OG0009863	0	0	4	0	0	4
OG0009864	0	0	4	0	0	4
OG0009865	0	0	3	1	0	4
OG0009866	0	0	3	1	0	4
OG0009867	0	0	1	3	0	4
OG0009868	0	0	1	2	1	4
OG0009869	0	0	3	0	1	4
OG0009870	0	0	2	0	2	4
OG0009871	0	0	4	0	0	4
OG0009872	0	0	4	0	0	4
OG0009873	0	0	1	3	0	4
OG0009874	0	0	4	0	0	4
OG0009875	0	0	4	0	0	4
OG0009876	0	0	2	2	0	4
OG0009877	0	0	1	1	2	4
OG0009878	0	0	1	0	3	4
OG0009879	0	0	3	0	1	4
OG0009880	0	0	1	3	0	4
OG0009881	0	0	4	0	0	4
OG0009882	0	0	4	0	0	4
OG0009883	0	0	1	0	3	4
OG0009884	0	0	3	0	1	4
OG0009885	0	0	2	2	0	4
OG0009886	0	0	1	3	0	4
OG0009887	0	0	3	1	0	4
OG0009888	0	0	3	0	1	4
OG0009889	0	0	1	3	0	4
OG0009890	0	0	1	3	0	4
OG0009891	0	0	2	2	0	4
OG0009892	0	0	2	2	0	4
OG0009893	0	0	4	0	0	4
OG0009894	0	0	3	0	1	4
OG0009895	0	0	1	2	1	4
OG0009896	0	0	3	0	1	4
OG0009897	0	0	3	1	0	4
OG0009898	0	0	3	1	0	4
OG0009899	0	0	3	0	1	4
OG0009900	0	0	2	1	1	4
OG0009901	0	0	1	2	1	4
OG0009902	0	0	1	2	1	4
OG0009903	0	0	3	1	0	4
OG0009904	0	0	4	0	0	4
OG0009905	0	0	2	2	0	4
OG0009906	0	0	2	2	0	4
OG0009907	0	0	2	0	2	4
OG0009908	0	0	3	1	0	4
OG0009909	0	0	4	0	0	4
OG0009910	0	0	4	0	0	4
OG0009911	0	0	4	0	0	4
OG0009912	0	0	2	1	1	4
OG0009913	0	0	3	0	1	4
OG0009914	0	0	1	3	0	4
OG0009915	0	0	2	1	1	4
OG0009916	0	0	1	2	1	4
OG0009917	0	0	2	1	1	4
OG0009918	0	0	3	1	0	4
OG0009919	0	0	2	1	1	4
OG0009920	0	0	2	0	2	4
OG0009921	0	0	1	0	3	4
OG0009922	0	0	4	0	0	4
OG0009923	0	0	2	2	0	4
OG0009924	0	0	3	1	0	4
OG0009925	0	0	2	1	1	4
OG0009926	0	0	1	2	1	4
OG0009927	0	0	3	0	1	4
OG0009928	0	0	1	0	3	4
OG0009929	0	0	1	3	0	4
OG0009930	0	0	1	3	0	4
OG0009931	0	0	1	3	0	4
OG0009932	0	0	2	1	1	4
OG0009933	0	0	2	1	1	4
OG0009934	0	0	1	3	0	4
OG0009935	0	0	1	3	0	4
OG0009936	0	0	3	0	1	4
OG0009937	0	0	4	0	0	4
OG0009938	0	0	2	1	1	4
OG0009939	0	0	4	0	0	4
OG0009940	0	0	4	0	0	4
OG0009941	0	0	3	1	0	4
OG0009942	0	0	1	1	2	4
OG0009943	0	0	3	1	0	4
OG0009944	0	0	2	1	1	4
OG0009945	0	0	1	3	0	4
OG0009946	0	0	1	3	0	4
OG0009947	0	0	2	2	0	4
OG0009948	0	0	2	1	1	4
OG0009949	0	0	2	2	0	4
OG0009950	0	0	2	0	2	4
OG0009951	0	0	4	0	0	4
OG0009952	0	0	4	0	0	4
OG0009953	0	0	1	0	3	4
OG0009954	0	0	1	3	0	4
OG0009955	0	0	1	3	0	4
OG0009956	0	0	1	3	0	4
OG0009957	0	0	1	0	3	4
OG0009958	0	0	2	0	2	4
OG0009959	0	0	2	2	0	4
OG0009960	0	0	1	3	0	4
OG0009961	0	0	1	3	0	4
OG0009962	0	0	2	1	1	4
OG0009963	0	0	1	3	0	4
OG0009964	0	0	1	3	0	4
OG0009965	0	0	0	4	0	4
OG0009966	0	0	0	4	0	4
OG0009967	0	0	0	4	0	4
OG0009968	0	0	0	4	0	4
OG0009969	0	0	0	4	0	4
OG0009970	0	0	0	4	0	4
OG0009971	0	0	0	4	0	4
OG0009972	0	0	0	2	2	4
OG0009973	0	0	0	3	1	4
OG0009974	0	0	0	4	0	4
OG0009975	0	0	0	4	0	4
OG0009976	0	0	0	4	0	4
OG0009977	0	0	0	4	0	4
OG0009978	0	0	0	4	0	4
OG0009979	0	0	0	4	0	4
OG0009980	0	0	0	2	2	4
OG0009981	0	0	0	4	0	4
OG0009982	0	0	0	4	0	4
OG0009983	0	0	0	4	0	4
OG0009984	0	0	0	2	2	4
OG0009985	0	0	0	4	0	4
OG0009986	0	0	0	4	0	4
OG0009987	0	0	0	4	0	4
OG0009988	0	0	0	4	0	4
OG0009989	0	0	0	2	2	4
OG0009990	0	0	0	4	0	4
OG0009991	0	0	0	4	0	4
OG0009992	0	0	0	4	0	4
OG0009993	0	0	0	4	0	4
OG0009994	0	0	0	4	0	4
OG0009995	0	0	0	4	0	4
OG0009996	0	0	0	4	0	4
OG0009997	0	0	0	4	0	4
OG0009998	0	0	0	4	0	4
OG0009999	0	0	0	2	2	4
OG0010000	0	0	0	4	0	4
OG0010001	0	0	0	4	0	4
OG0010002	0	0	0	1	3	4
OG0010003	0	0	0	4	0	4
OG0010004	0	0	0	4	0	4
OG0010005	0	0	0	1	3	4
OG0010006	0	0	0	4	0	4
OG0010007	0	0	0	4	0	4
OG0010008	0	0	0	1	3	4
OG0010009	0	0	0	4	0	4
OG0010010	0	0	0	4	0	4
OG0010011	0	0	0	4	0	4
OG0010012	0	0	0	1	3	4
OG0010013	0	0	0	0	4	4
OG0010014	0	0	0	0	4	4
OG0010015	0	0	0	0	4	4
OG0010016	0	0	0	0	4	4
OG0010017	0	0	0	0	4	4
OG0010018	0	0	0	0	4	4
OG0010019	1	0	1	1	0	3
OG0010020	3	0	0	0	0	3
OG0010021	3	0	0	0	0	3
OG0010022	1	0	2	0	0	3
OG0010023	3	0	0	0	0	3
OG0010024	1	0	0	0	2	3
OG0010025	1	0	1	0	1	3
OG0010026	2	0	0	0	1	3
OG0010027	2	0	1	0	0	3
OG0010028	1	1	1	0	0	3
OG0010029	2	0	1	0	0	3
OG0010030	1	0	1	0	1	3
OG0010031	3	0	0	0	0	3
OG0010032	2	0	1	0	0	3
OG0010033	1	0	1	0	1	3
OG0010034	2	0	1	0	0	3
OG0010035	1	0	0	2	0	3
OG0010036	2	0	1	0	0	3
OG0010037	2	0	1	0	0	3
OG0010038	1	1	1	0	0	3
OG0010039	2	0	1	0	0	3
OG0010040	1	0	1	0	1	3
OG0010041	1	0	2	0	0	3
OG0010042	1	0	2	0	0	3
OG0010043	1	0	0	1	1	3
OG0010044	1	1	1	0	0	3
OG0010045	2	0	1	0	0	3
OG0010046	2	0	1	0	0	3
OG0010047	1	0	1	0	1	3
OG0010048	2	0	1	0	0	3
OG0010049	1	0	1	0	1	3
OG0010050	3	0	0	0	0	3
OG0010051	1	0	2	0	0	3
OG0010052	1	0	2	0	0	3
OG0010053	2	0	1	0	0	3
OG0010054	1	0	1	1	0	3
OG0010055	2	0	1	0	0	3
OG0010056	1	0	0	2	0	3
OG0010057	3	0	0	0	0	3
OG0010058	1	1	1	0	0	3
OG0010059	3	0	0	0	0	3
OG0010060	3	0	0	0	0	3
OG0010061	2	0	1	0	0	3
OG0010062	2	0	1	0	0	3
OG0010063	1	1	1	0	0	3
OG0010064	2	0	1	0	0	3
OG0010065	3	0	0	0	0	3
OG0010066	3	0	0	0	0	3
OG0010067	1	0	2	0	0	3
OG0010068	3	0	0	0	0	3
OG0010069	1	1	0	1	0	3
OG0010070	3	0	0	0	0	3
OG0010071	1	0	1	1	0	3
OG0010072	1	1	0	1	0	3
OG0010073	3	0	0	0	0	3
OG0010074	1	0	0	2	0	3
OG0010075	1	0	1	1	0	3
OG0010076	1	0	1	0	1	3
OG0010077	2	0	1	0	0	3
OG0010078	1	0	1	1	0	3
OG0010079	2	0	1	0	0	3
OG0010080	3	0	0	0	0	3
OG0010081	1	1	0	1	0	3
OG0010082	1	0	1	1	0	3
OG0010083	1	0	2	0	0	3
OG0010084	1	0	2	0	0	3
OG0010085	2	0	1	0	0	3
OG0010086	1	1	0	1	0	3
OG0010087	1	0	2	0	0	3
OG0010088	1	0	2	0	0	3
OG0010089	2	0	1	0	0	3
OG0010090	3	0	0	0	0	3
OG0010091	2	0	1	0	0	3
OG0010092	3	0	0	0	0	3
OG0010093	1	0	0	0	2	3
OG0010094	3	0	0	0	0	3
OG0010095	1	0	2	0	0	3
OG0010096	3	0	0	0	0	3
OG0010097	2	0	1	0	0	3
OG0010098	2	0	1	0	0	3
OG0010099	1	0	1	1	0	3
OG0010100	1	1	0	1	0	3
OG0010101	1	0	1	1	0	3
OG0010102	1	0	1	1	0	3
OG0010103	1	0	2	0	0	3
OG0010104	2	0	1	0	0	3
OG0010105	3	0	0	0	0	3
OG0010106	1	0	2	0	0	3
OG0010107	3	0	0	0	0	3
OG0010108	1	0	2	0	0	3
OG0010109	2	0	1	0	0	3
OG0010110	1	0	2	0	0	3
OG0010111	1	0	0	1	1	3
OG0010112	1	0	2	0	0	3
OG0010113	2	0	1	0	0	3
OG0010114	3	0	0	0	0	3
OG0010115	2	0	1	0	0	3
OG0010116	2	0	1	0	0	3
OG0010117	1	0	1	0	1	3
OG0010118	2	0	1	0	0	3
OG0010119	2	0	1	0	0	3
OG0010120	3	0	0	0	0	3
OG0010121	1	0	2	0	0	3
OG0010122	1	1	1	0	0	3
OG0010123	3	0	0	0	0	3
OG0010124	3	0	0	0	0	3
OG0010125	1	0	1	0	1	3
OG0010126	1	0	2	0	0	3
OG0010127	1	0	1	1	0	3
OG0010128	1	0	1	1	0	3
OG0010129	2	0	1	0	0	3
OG0010130	3	0	0	0	0	3
OG0010131	1	1	0	1	0	3
OG0010132	1	0	1	1	0	3
OG0010133	2	0	1	0	0	3
OG0010134	1	0	2	0	0	3
OG0010135	1	1	0	1	0	3
OG0010136	2	0	1	0	0	3
OG0010137	1	0	1	1	0	3
OG0010138	1	0	2	0	0	3
OG0010139	3	0	0	0	0	3
OG0010140	1	1	0	1	0	3
OG0010141	2	0	0	0	1	3
OG0010142	1	1	1	0	0	3
OG0010143	1	0	2	0	0	3
OG0010144	3	0	0	0	0	3
OG0010145	1	0	1	1	0	3
OG0010146	1	1	0	1	0	3
OG0010147	2	0	0	1	0	3
OG0010148	1	0	0	0	2	3
OG0010149	1	0	2	0	0	3
OG0010150	1	0	2	0	0	3
OG0010151	1	0	2	0	0	3
OG0010152	1	0	0	2	0	3
OG0010153	2	0	0	1	0	3
OG0010154	2	0	0	1	0	3
OG0010155	1	0	2	0	0	3
OG0010156	3	0	0	0	0	3
OG0010157	1	1	0	1	0	3
OG0010158	2	0	0	1	0	3
OG0010159	1	0	0	2	0	3
OG0010160	0	1	0	2	0	3
OG0010161	0	1	0	2	0	3
OG0010162	0	2	0	1	0	3
OG0010163	0	1	0	2	0	3
OG0010164	0	1	0	2	0	3
OG0010165	0	1	0	2	0	3
OG0010166	0	2	0	1	0	3
OG0010167	0	1	1	1	0	3
OG0010168	0	1	1	1	0	3
OG0010169	0	1	0	2	0	3
OG0010170	0	1	0	1	1	3
OG0010171	0	1	1	1	0	3
OG0010172	0	1	0	2	0	3
OG0010173	0	1	0	2	0	3
OG0010174	0	1	0	2	0	3
OG0010175	0	2	0	1	0	3
OG0010176	0	1	0	2	0	3
OG0010177	0	2	0	1	0	3
OG0010178	0	1	0	2	0	3
OG0010179	0	1	1	1	0	3
OG0010180	0	3	0	0	0	3
OG0010181	0	1	0	1	1	3
OG0010182	0	1	1	1	0	3
OG0010183	0	1	1	1	0	3
OG0010184	0	1	1	0	1	3
OG0010185	0	2	0	1	0	3
OG0010186	0	1	0	2	0	3
OG0010187	0	1	1	1	0	3
OG0010188	0	1	1	1	0	3
OG0010189	0	1	0	2	0	3
OG0010190	0	1	1	1	0	3
OG0010191	0	1	0	2	0	3
OG0010192	0	1	2	0	0	3
OG0010193	0	1	0	2	0	3
OG0010194	0	1	0	2	0	3
OG0010195	0	1	0	2	0	3
OG0010196	0	1	0	2	0	3
OG0010197	0	1	0	2	0	3
OG0010198	0	2	0	1	0	3
OG0010199	0	1	0	2	0	3
OG0010200	0	1	0	2	0	3
OG0010201	0	1	0	2	0	3
OG0010202	0	1	0	2	0	3
OG0010203	0	1	1	1	0	3
OG0010204	0	2	0	1	0	3
OG0010205	0	1	0	2	0	3
OG0010206	0	1	0	2	0	3
OG0010207	0	1	0	2	0	3
OG0010208	0	2	0	1	0	3
OG0010209	0	1	2	0	0	3
OG0010210	0	1	0	2	0	3
OG0010211	0	1	0	2	0	3
OG0010212	0	3	0	0	0	3
OG0010213	0	2	0	1	0	3
OG0010214	0	2	0	1	0	3
OG0010215	0	1	1	1	0	3
OG0010216	0	1	0	2	0	3
OG0010217	0	3	0	0	0	3
OG0010218	0	1	0	2	0	3
OG0010219	0	2	0	1	0	3
OG0010220	0	1	1	1	0	3
OG0010221	0	1	0	2	0	3
OG0010222	0	1	1	1	0	3
OG0010223	0	2	0	1	0	3
OG0010224	0	2	0	1	0	3
OG0010225	0	1	0	2	0	3
OG0010226	0	1	0	2	0	3
OG0010227	0	1	1	1	0	3
OG0010228	0	1	0	2	0	3
OG0010229	0	1	0	2	0	3
OG0010230	0	1	0	2	0	3
OG0010231	0	2	1	0	0	3
OG0010232	0	1	1	1	0	3
OG0010233	0	1	0	2	0	3
OG0010234	0	3	0	0	0	3
OG0010235	0	3	0	0	0	3
OG0010236	0	2	1	0	0	3
OG0010237	0	1	0	2	0	3
OG0010238	0	1	0	2	0	3
OG0010239	0	1	0	1	1	3
OG0010240	0	1	0	2	0	3
OG0010241	0	1	0	2	0	3
OG0010242	0	1	0	2	0	3
OG0010243	0	1	0	2	0	3
OG0010244	0	1	1	1	0	3
OG0010245	0	1	1	1	0	3
OG0010246	0	1	0	2	0	3
OG0010247	0	1	0	2	0	3
OG0010248	0	1	0	2	0	3
OG0010249	0	2	0	1	0	3
OG0010250	0	1	0	2	0	3
OG0010251	0	1	1	1	0	3
OG0010252	0	1	1	1	0	3
OG0010253	0	1	2	0	0	3
OG0010254	0	1	0	2	0	3
OG0010255	0	1	1	1	0	3
OG0010256	0	2	0	1	0	3
OG0010257	0	1	1	1	0	3
OG0010258	0	2	0	1	0	3
OG0010259	0	1	1	1	0	3
OG0010260	0	1	0	2	0	3
OG0010261	0	3	0	0	0	3
OG0010262	0	1	0	2	0	3
OG0010263	0	1	0	2	0	3
OG0010264	0	3	0	0	0	3
OG0010265	0	1	0	2	0	3
OG0010266	0	1	0	2	0	3
OG0010267	0	1	0	2	0	3
OG0010268	0	1	0	2	0	3
OG0010269	0	1	0	2	0	3
OG0010270	0	1	0	2	0	3
OG0010271	0	1	1	1	0	3
OG0010272	0	1	0	2	0	3
OG0010273	0	1	0	2	0	3
OG0010274	0	1	0	2	0	3
OG0010275	0	1	0	2	0	3
OG0010276	0	3	0	0	0	3
OG0010277	0	1	0	2	0	3
OG0010278	0	1	0	2	0	3
OG0010279	0	2	0	1	0	3
OG0010280	0	1	1	1	0	3
OG0010281	0	1	0	2	0	3
OG0010282	0	2	0	1	0	3
OG0010283	0	1	0	2	0	3
OG0010284	0	1	0	2	0	3
OG0010285	0	1	0	2	0	3
OG0010286	0	1	0	2	0	3
OG0010287	0	2	0	1	0	3
OG0010288	0	1	0	2	0	3
OG0010289	0	1	0	2	0	3
OG0010290	0	1	0	2	0	3
OG0010291	0	1	0	2	0	3
OG0010292	0	1	0	2	0	3
OG0010293	0	1	0	2	0	3
OG0010294	0	1	0	2	0	3
OG0010295	0	1	0	2	0	3
OG0010296	0	1	0	2	0	3
OG0010297	0	1	0	2	0	3
OG0010298	0	1	0	2	0	3
OG0010299	0	1	0	2	0	3
OG0010300	0	1	1	1	0	3
OG0010301	0	1	1	1	0	3
OG0010302	0	1	0	2	0	3
OG0010303	0	1	0	2	0	3
OG0010304	0	1	0	2	0	3
OG0010305	0	1	0	2	0	3
OG0010306	0	1	0	2	0	3
OG0010307	0	1	0	2	0	3
OG0010308	0	1	0	2	0	3
OG0010309	0	1	0	2	0	3
OG0010310	0	1	1	1	0	3
OG0010311	0	1	0	2	0	3
OG0010312	0	1	1	1	0	3
OG0010313	0	1	0	2	0	3
OG0010314	0	1	1	1	0	3
OG0010315	0	2	0	1	0	3
OG0010316	0	1	0	1	1	3
OG0010317	0	2	1	0	0	3
OG0010318	0	1	0	2	0	3
OG0010319	0	1	1	1	0	3
OG0010320	0	1	0	2	0	3
OG0010321	0	2	0	1	0	3
OG0010322	0	1	0	2	0	3
OG0010323	0	2	1	0	0	3
OG0010324	0	1	0	2	0	3
OG0010325	0	1	2	0	0	3
OG0010326	0	1	0	2	0	3
OG0010327	0	2	0	1	0	3
OG0010328	0	1	1	1	0	3
OG0010329	0	1	0	2	0	3
OG0010330	0	2	1	0	0	3
OG0010331	0	1	1	1	0	3
OG0010332	0	1	0	2	0	3
OG0010333	0	3	0	0	0	3
OG0010334	0	1	0	2	0	3
OG0010335	0	2	0	1	0	3
OG0010336	0	3	0	0	0	3
OG0010337	0	3	0	0	0	3
OG0010338	0	1	0	2	0	3
OG0010339	0	1	0	2	0	3
OG0010340	0	1	0	2	0	3
OG0010341	0	1	0	2	0	3
OG0010342	0	1	0	2	0	3
OG0010343	0	3	0	0	0	3
OG0010344	0	1	0	2	0	3
OG0010345	0	1	0	2	0	3
OG0010346	0	2	0	1	0	3
OG0010347	0	1	0	2	0	3
OG0010348	0	1	0	2	0	3
OG0010349	0	1	1	1	0	3
OG0010350	0	1	0	2	0	3
OG0010351	0	1	2	0	0	3
OG0010352	0	2	0	1	0	3
OG0010353	0	3	0	0	0	3
OG0010354	0	1	0	2	0	3
OG0010355	0	2	0	1	0	3
OG0010356	0	1	0	2	0	3
OG0010357	0	1	1	1	0	3
OG0010358	0	3	0	0	0	3
OG0010359	0	2	0	1	0	3
OG0010360	0	2	0	1	0	3
OG0010361	0	2	0	1	0	3
OG0010362	0	3	0	0	0	3
OG0010363	0	1	0	2	0	3
OG0010364	0	2	0	1	0	3
OG0010365	0	1	0	2	0	3
OG0010366	0	1	0	2	0	3
OG0010367	0	1	1	1	0	3
OG0010368	0	3	0	0	0	3
OG0010369	0	1	0	2	0	3
OG0010370	0	2	0	1	0	3
OG0010371	0	1	0	2	0	3
OG0010372	0	1	1	1	0	3
OG0010373	0	2	1	0	0	3
OG0010374	0	2	0	1	0	3
OG0010375	0	3	0	0	0	3
OG0010376	0	2	0	1	0	3
OG0010377	0	1	0	2	0	3
OG0010378	0	3	0	0	0	3
OG0010379	0	3	0	0	0	3
OG0010380	0	3	0	0	0	3
OG0010381	0	1	0	2	0	3
OG0010382	0	1	0	2	0	3
OG0010383	0	1	1	1	0	3
OG0010384	0	3	0	0	0	3
OG0010385	0	1	0	2	0	3
OG0010386	0	1	0	2	0	3
OG0010387	0	1	0	2	0	3
OG0010388	0	1	1	1	0	3
OG0010389	0	1	1	1	0	3
OG0010390	0	2	0	1	0	3
OG0010391	0	2	0	1	0	3
OG0010392	0	2	0	1	0	3
OG0010393	0	1	0	2	0	3
OG0010394	0	1	0	2	0	3
OG0010395	0	1	1	1	0	3
OG0010396	0	1	0	2	0	3
OG0010397	0	2	0	1	0	3
OG0010398	0	1	0	2	0	3
OG0010399	0	2	0	1	0	3
OG0010400	0	2	0	1	0	3
OG0010401	0	1	0	2	0	3
OG0010402	0	2	0	1	0	3
OG0010403	0	2	0	1	0	3
OG0010404	0	1	1	1	0	3
OG0010405	0	1	0	2	0	3
OG0010406	0	2	0	1	0	3
OG0010407	0	1	1	1	0	3
OG0010408	0	1	0	2	0	3
OG0010409	0	1	0	2	0	3
OG0010410	0	3	0	0	0	3
OG0010411	0	1	0	2	0	3
OG0010412	0	2	0	1	0	3
OG0010413	0	1	0	2	0	3
OG0010414	0	2	0	1	0	3
OG0010415	0	2	0	1	0	3
OG0010416	0	1	1	1	0	3
OG0010417	0	2	0	1	0	3
OG0010418	0	2	0	1	0	3
OG0010419	0	2	0	1	0	3
OG0010420	0	1	0	2	0	3
OG0010421	0	3	0	0	0	3
OG0010422	0	2	0	1	0	3
OG0010423	0	1	0	2	0	3
OG0010424	0	1	1	1	0	3
OG0010425	0	2	0	1	0	3
OG0010426	0	1	0	2	0	3
OG0010427	0	1	0	2	0	3
OG0010428	0	2	0	1	0	3
OG0010429	0	3	0	0	0	3
OG0010430	0	1	1	1	0	3
OG0010431	0	1	0	2	0	3
OG0010432	0	3	0	0	0	3
OG0010433	0	1	0	2	0	3
OG0010434	0	1	0	2	0	3
OG0010435	0	2	0	1	0	3
OG0010436	0	2	1	0	0	3
OG0010437	0	2	1	0	0	3
OG0010438	0	1	2	0	0	3
OG0010439	0	1	0	2	0	3
OG0010440	0	1	0	2	0	3
OG0010441	0	2	0	1	0	3
OG0010442	0	3	0	0	0	3
OG0010443	0	1	0	2	0	3
OG0010444	0	1	0	2	0	3
OG0010445	0	1	1	1	0	3
OG0010446	0	2	0	1	0	3
OG0010447	0	1	0	2	0	3
OG0010448	0	1	2	0	0	3
OG0010449	0	1	0	2	0	3
OG0010450	0	1	0	2	0	3
OG0010451	0	3	0	0	0	3
OG0010452	0	2	0	1	0	3
OG0010453	0	1	1	1	0	3
OG0010454	0	1	0	2	0	3
OG0010455	0	1	0	2	0	3
OG0010456	0	1	1	0	1	3
OG0010457	0	2	0	1	0	3
OG0010458	0	1	0	2	0	3
OG0010459	0	1	0	2	0	3
OG0010460	0	1	1	1	0	3
OG0010461	0	1	0	2	0	3
OG0010462	0	1	1	1	0	3
OG0010463	0	2	0	1	0	3
OG0010464	0	1	0	2	0	3
OG0010465	0	1	0	2	0	3
OG0010466	0	1	0	2	0	3
OG0010467	0	1	0	2	0	3
OG0010468	0	1	0	2	0	3
OG0010469	0	2	0	1	0	3
OG0010470	0	2	0	1	0	3
OG0010471	0	1	0	2	0	3
OG0010472	0	1	1	1	0	3
OG0010473	0	1	0	2	0	3
OG0010474	0	1	0	2	0	3
OG0010475	0	2	0	1	0	3
OG0010476	0	1	0	2	0	3
OG0010477	0	3	0	0	0	3
OG0010478	0	1	1	1	0	3
OG0010479	0	1	0	2	0	3
OG0010480	0	1	0	2	0	3
OG0010481	0	3	0	0	0	3
OG0010482	0	1	0	2	0	3
OG0010483	0	1	0	2	0	3
OG0010484	0	1	1	1	0	3
OG0010485	0	1	0	2	0	3
OG0010486	0	2	0	1	0	3
OG0010487	0	1	1	1	0	3
OG0010488	0	1	0	2	0	3
OG0010489	0	1	0	2	0	3
OG0010490	0	1	1	1	0	3
OG0010491	0	1	0	2	0	3
OG0010492	0	1	0	2	0	3
OG0010493	0	1	0	2	0	3
OG0010494	0	1	0	2	0	3
OG0010495	0	1	0	2	0	3
OG0010496	0	1	0	2	0	3
OG0010497	0	1	0	0	2	3
OG0010498	0	1	1	1	0	3
OG0010499	0	1	1	1	0	3
OG0010500	0	1	0	2	0	3
OG0010501	0	1	0	2	0	3
OG0010502	0	1	0	2	0	3
OG0010503	0	1	1	1	0	3
OG0010504	0	1	0	2	0	3
OG0010505	0	1	1	1	0	3
OG0010506	0	1	0	1	1	3
OG0010507	0	1	1	1	0	3
OG0010508	0	1	0	2	0	3
OG0010509	0	1	0	2	0	3
OG0010510	0	1	0	2	0	3
OG0010511	0	1	0	2	0	3
OG0010512	0	1	1	1	0	3
OG0010513	0	1	0	2	0	3
OG0010514	0	1	1	1	0	3
OG0010515	0	1	0	2	0	3
OG0010516	0	1	0	2	0	3
OG0010517	0	1	1	1	0	3
OG0010518	0	1	0	1	1	3
OG0010519	0	1	0	2	0	3
OG0010520	0	1	1	1	0	3
OG0010521	0	1	0	2	0	3
OG0010522	0	1	2	0	0	3
OG0010523	0	1	0	2	0	3
OG0010524	0	1	0	2	0	3
OG0010525	0	1	1	1	0	3
OG0010526	0	1	0	2	0	3
OG0010527	0	1	0	2	0	3
OG0010528	0	1	1	1	0	3
OG0010529	0	1	1	1	0	3
OG0010530	0	1	1	1	0	3
OG0010531	0	1	0	2	0	3
OG0010532	0	1	0	2	0	3
OG0010533	0	1	0	2	0	3
OG0010534	0	1	0	2	0	3
OG0010535	0	1	1	1	0	3
OG0010536	0	1	0	0	2	3
OG0010537	0	1	0	2	0	3
OG0010538	0	1	0	2	0	3
OG0010539	0	1	2	0	0	3
OG0010540	0	2	0	1	0	3
OG0010541	0	1	0	1	1	3
OG0010542	0	1	1	1	0	3
OG0010543	0	1	1	1	0	3
OG0010544	0	1	2	0	0	3
OG0010545	0	1	1	1	0	3
OG0010546	0	1	0	2	0	3
OG0010547	0	0	3	0	0	3
OG0010548	0	0	1	1	1	3
OG0010549	0	0	2	0	1	3
OG0010550	0	0	2	0	1	3
OG0010551	0	0	3	0	0	3
OG0010552	0	0	3	0	0	3
OG0010553	0	0	2	1	0	3
OG0010554	0	0	2	0	1	3
OG0010555	0	0	2	1	0	3
OG0010556	0	0	3	0	0	3
OG0010557	0	0	2	1	0	3
OG0010558	0	0	2	1	0	3
OG0010559	0	0	2	1	0	3
OG0010560	0	0	1	2	0	3
OG0010561	0	0	1	1	1	3
OG0010562	0	0	3	0	0	3
OG0010563	0	0	1	2	0	3
OG0010564	0	0	3	0	0	3
OG0010565	0	0	1	0	2	3
OG0010566	0	0	2	1	0	3
OG0010567	0	0	3	0	0	3
OG0010568	0	0	2	1	0	3
OG0010569	0	0	1	2	0	3
OG0010570	0	0	2	0	1	3
OG0010571	0	0	1	2	0	3
OG0010572	0	0	1	0	2	3
OG0010573	0	0	3	0	0	3
OG0010574	0	0	1	0	2	3
OG0010575	0	0	1	0	2	3
OG0010576	0	0	1	1	1	3
OG0010577	0	0	2	0	1	3
OG0010578	0	0	3	0	0	3
OG0010579	0	0	3	0	0	3
OG0010580	0	0	2	0	1	3
OG0010581	0	0	1	2	0	3
OG0010582	0	0	2	0	1	3
OG0010583	0	0	2	0	1	3
OG0010584	0	0	1	2	0	3
OG0010585	0	0	2	1	0	3
OG0010586	0	0	3	0	0	3
OG0010587	0	0	2	1	0	3
OG0010588	0	0	2	0	1	3
OG0010589	0	0	2	1	0	3
OG0010590	0	0	2	0	1	3
OG0010591	0	0	1	2	0	3
OG0010592	0	0	3	0	0	3
OG0010593	0	0	1	2	0	3
OG0010594	0	0	1	2	0	3
OG0010595	0	0	2	0	1	3
OG0010596	0	0	1	1	1	3
OG0010597	0	0	2	0	1	3
OG0010598	0	0	3	0	0	3
OG0010599	0	0	2	0	1	3
OG0010600	0	0	3	0	0	3
OG0010601	0	0	1	1	1	3
OG0010602	0	0	2	0	1	3
OG0010603	0	0	1	2	0	3
OG0010604	0	0	2	1	0	3
OG0010605	0	0	3	0	0	3
OG0010606	0	0	3	0	0	3
OG0010607	0	0	1	2	0	3
OG0010608	0	0	2	0	1	3
OG0010609	0	0	2	1	0	3
OG0010610	0	0	1	1	1	3
OG0010611	0	0	2	1	0	3
OG0010612	0	0	3	0	0	3
OG0010613	0	0	2	1	0	3
OG0010614	0	0	1	0	2	3
OG0010615	0	0	2	1	0	3
OG0010616	0	0	1	2	0	3
OG0010617	0	0	2	0	1	3
OG0010618	0	0	2	0	1	3
OG0010619	0	0	1	0	2	3
OG0010620	0	0	2	0	1	3
OG0010621	0	0	2	0	1	3
OG0010622	0	0	2	1	0	3
OG0010623	0	0	2	0	1	3
OG0010624	0	0	2	0	1	3
OG0010625	0	0	2	1	0	3
OG0010626	0	0	2	1	0	3
OG0010627	0	0	1	1	1	3
OG0010628	0	0	1	2	0	3
OG0010629	0	0	1	1	1	3
OG0010630	0	0	2	0	1	3
OG0010631	0	0	1	0	2	3
OG0010632	0	0	1	2	0	3
OG0010633	0	0	1	1	1	3
OG0010634	0	0	1	0	2	3
OG0010635	0	0	2	0	1	3
OG0010636	0	0	1	2	0	3
OG0010637	0	0	2	1	0	3
OG0010638	0	0	1	2	0	3
OG0010639	0	0	1	2	0	3
OG0010640	0	0	3	0	0	3
OG0010641	0	0	2	1	0	3
OG0010642	0	0	1	2	0	3
OG0010643	0	0	3	0	0	3
OG0010644	0	0	3	0	0	3
OG0010645	0	0	3	0	0	3
OG0010646	0	0	1	2	0	3
OG0010647	0	0	1	1	1	3
OG0010648	0	0	2	0	1	3
OG0010649	0	0	3	0	0	3
OG0010650	0	0	1	1	1	3
OG0010651	0	0	1	2	0	3
OG0010652	0	0	3	0	0	3
OG0010653	0	0	1	2	0	3
OG0010654	0	0	2	0	1	3
OG0010655	0	0	1	0	2	3
OG0010656	0	0	2	0	1	3
OG0010657	0	0	3	0	0	3
OG0010658	0	0	1	2	0	3
OG0010659	0	0	1	1	1	3
OG0010660	0	0	3	0	0	3
OG0010661	0	0	1	2	0	3
OG0010662	0	0	2	1	0	3
OG0010663	0	0	1	1	1	3
OG0010664	0	0	2	1	0	3
OG0010665	0	0	1	2	0	3
OG0010666	0	0	1	0	2	3
OG0010667	0	0	2	0	1	3
OG0010668	0	0	2	0	1	3
OG0010669	0	0	2	0	1	3
OG0010670	0	0	2	1	0	3
OG0010671	0	0	1	2	0	3
OG0010672	0	0	1	2	0	3
OG0010673	0	0	2	0	1	3
OG0010674	0	0	2	0	1	3
OG0010675	0	0	1	2	0	3
OG0010676	0	0	1	1	1	3
OG0010677	0	0	2	1	0	3
OG0010678	0	0	1	0	2	3
OG0010679	0	0	1	2	0	3
OG0010680	0	0	2	1	0	3
OG0010681	0	0	1	2	0	3
OG0010682	0	0	3	0	0	3
OG0010683	0	0	2	1	0	3
OG0010684	0	0	1	0	2	3
OG0010685	0	0	3	0	0	3
OG0010686	0	0	1	2	0	3
OG0010687	0	0	1	0	2	3
OG0010688	0	0	3	0	0	3
OG0010689	0	0	3	0	0	3
OG0010690	0	0	1	0	2	3
OG0010691	0	0	2	1	0	3
OG0010692	0	0	1	2	0	3
OG0010693	0	0	2	0	1	3
OG0010694	0	0	1	0	2	3
OG0010695	0	0	1	2	0	3
OG0010696	0	0	1	2	0	3
OG0010697	0	0	1	2	0	3
OG0010698	0	0	1	2	0	3
OG0010699	0	0	1	0	2	3
OG0010700	0	0	2	1	0	3
OG0010701	0	0	2	0	1	3
OG0010702	0	0	1	0	2	3
OG0010703	0	0	1	2	0	3
OG0010704	0	0	3	0	0	3
OG0010705	0	0	2	0	1	3
OG0010706	0	0	2	1	0	3
OG0010707	0	0	1	0	2	3
OG0010708	0	0	1	0	2	3
OG0010709	0	0	1	2	0	3
OG0010710	0	0	2	0	1	3
OG0010711	0	0	1	2	0	3
OG0010712	0	0	1	0	2	3
OG0010713	0	0	1	1	1	3
OG0010714	0	0	3	0	0	3
OG0010715	0	0	1	0	2	3
OG0010716	0	0	1	2	0	3
OG0010717	0	0	2	0	1	3
OG0010718	0	0	2	0	1	3
OG0010719	0	0	0	3	0	3
OG0010720	0	0	0	3	0	3
OG0010721	0	0	0	3	0	3
OG0010722	0	0	0	3	0	3
OG0010723	0	0	0	3	0	3
OG0010724	0	0	0	3	0	3
OG0010725	0	0	0	3	0	3
OG0010726	0	0	0	3	0	3
OG0010727	0	0	0	3	0	3
OG0010728	0	0	0	3	0	3
OG0010729	0	0	0	3	0	3
OG0010730	0	0	0	3	0	3
OG0010731	0	0	0	3	0	3
OG0010732	0	0	0	3	0	3
OG0010733	0	0	0	3	0	3
OG0010734	0	0	0	3	0	3
OG0010735	0	0	0	3	0	3
OG0010736	0	0	0	3	0	3
OG0010737	0	0	0	3	0	3
OG0010738	0	0	0	3	0	3
OG0010739	0	0	0	3	0	3
OG0010740	0	0	0	3	0	3
OG0010741	0	0	0	3	0	3
OG0010742	0	0	0	3	0	3
OG0010743	0	0	0	1	2	3
OG0010744	0	0	0	3	0	3
OG0010745	0	0	0	2	1	3
OG0010746	0	0	0	3	0	3
OG0010747	0	0	0	3	0	3
OG0010748	0	0	0	3	0	3
OG0010749	0	0	0	3	0	3
OG0010750	0	0	0	3	0	3
OG0010751	0	0	0	3	0	3
OG0010752	0	0	0	3	0	3
OG0010753	0	0	0	3	0	3
OG0010754	0	0	0	3	0	3
OG0010755	0	0	0	3	0	3
OG0010756	0	0	0	3	0	3
OG0010757	0	0	0	3	0	3
OG0010758	0	0	0	3	0	3
OG0010759	0	0	0	3	0	3
OG0010760	0	0	0	3	0	3
OG0010761	0	0	0	3	0	3
OG0010762	0	0	0	3	0	3
OG0010763	0	0	0	3	0	3
OG0010764	0	0	0	1	2	3
OG0010765	0	0	0	3	0	3
OG0010766	0	0	0	1	2	3
OG0010767	0	0	0	1	2	3
OG0010768	0	0	0	3	0	3
OG0010769	0	0	0	3	0	3
OG0010770	0	0	0	3	0	3
OG0010771	0	0	0	3	0	3
OG0010772	0	0	0	2	1	3
OG0010773	0	0	0	1	2	3
OG0010774	0	0	0	3	0	3
OG0010775	0	0	0	3	0	3
OG0010776	0	0	0	2	1	3
OG0010777	0	0	0	1	2	3
OG0010778	0	0	0	2	1	3
OG0010779	0	0	0	3	0	3
OG0010780	0	0	0	2	1	3
OG0010781	0	0	0	3	0	3
OG0010782	0	0	0	3	0	3
OG0010783	0	0	0	1	2	3
OG0010784	0	0	0	1	2	3
OG0010785	0	0	0	1	2	3
OG0010786	0	0	0	1	2	3
OG0010787	0	0	0	3	0	3
OG0010788	0	0	0	1	2	3
OG0010789	0	0	0	0	3	3
OG0010790	0	0	0	0	3	3
OG0010791	0	0	0	0	3	3
OG0010792	0	0	0	0	3	3
OG0010793	0	0	0	0	3	3
OG0010794	0	0	0	0	3	3
OG0010795	0	0	0	0	3	3
OG0010796	0	0	0	0	3	3
OG0010797	0	0	0	0	3	3
OG0010798	0	0	0	0	3	3
OG0010799	0	0	0	0	3	3
OG0010800	0	0	0	0	3	3
OG0010801	1	0	1	0	0	2
OG0010802	1	0	1	0	0	2
OG0010803	1	0	1	0	0	2
OG0010804	1	0	1	0	0	2
OG0010805	1	0	1	0	0	2
OG0010806	1	0	0	1	0	2
OG0010807	2	0	0	0	0	2
OG0010808	1	0	1	0	0	2
OG0010809	2	0	0	0	0	2
OG0010810	1	0	1	0	0	2
OG0010811	1	0	1	0	0	2
OG0010812	1	0	1	0	0	2
OG0010813	1	0	1	0	0	2
OG0010814	1	0	1	0	0	2
OG0010815	2	0	0	0	0	2
OG0010816	2	0	0	0	0	2
OG0010817	1	0	1	0	0	2
OG0010818	1	0	1	0	0	2
OG0010819	2	0	0	0	0	2
OG0010820	1	0	1	0	0	2
OG0010821	2	0	0	0	0	2
OG0010822	1	0	1	0	0	2
OG0010823	1	0	0	1	0	2
OG0010824	1	0	1	0	0	2
OG0010825	1	0	1	0	0	2
OG0010826	2	0	0	0	0	2
OG0010827	2	0	0	0	0	2
OG0010828	2	0	0	0	0	2
OG0010829	2	0	0	0	0	2
OG0010830	2	0	0	0	0	2
OG0010831	2	0	0	0	0	2
OG0010832	1	0	1	0	0	2
OG0010833	1	0	1	0	0	2
OG0010834	1	0	1	0	0	2
OG0010835	2	0	0	0	0	2
OG0010836	2	0	0	0	0	2
OG0010837	1	0	0	0	1	2
OG0010838	2	0	0	0	0	2
OG0010839	1	0	1	0	0	2
OG0010840	1	0	1	0	0	2
OG0010841	1	0	1	0	0	2
OG0010842	1	0	1	0	0	2
OG0010843	1	0	1	0	0	2
OG0010844	1	0	1	0	0	2
OG0010845	2	0	0	0	0	2
OG0010846	1	0	1	0	0	2
OG0010847	1	0	1	0	0	2
OG0010848	1	0	1	0	0	2
OG0010849	1	0	0	1	0	2
OG0010850	2	0	0	0	0	2
OG0010851	1	0	1	0	0	2
OG0010852	1	0	0	0	1	2
OG0010853	1	0	1	0	0	2
OG0010854	2	0	0	0	0	2
OG0010855	1	0	1	0	0	2
OG0010856	1	0	1	0	0	2
OG0010857	2	0	0	0	0	2
OG0010858	2	0	0	0	0	2
OG0010859	2	0	0	0	0	2
OG0010860	1	0	1	0	0	2
OG0010861	2	0	0	0	0	2
OG0010862	1	0	1	0	0	2
OG0010863	1	0	1	0	0	2
OG0010864	1	0	1	0	0	2
OG0010865	1	0	1	0	0	2
OG0010866	2	0	0	0	0	2
OG0010867	2	0	0	0	0	2
OG0010868	1	0	0	1	0	2
OG0010869	1	0	1	0	0	2
OG0010870	1	0	1	0	0	2
OG0010871	1	0	1	0	0	2
OG0010872	2	0	0	0	0	2
OG0010873	2	0	0	0	0	2
OG0010874	1	0	1	0	0	2
OG0010875	2	0	0	0	0	2
OG0010876	1	0	1	0	0	2
OG0010877	1	0	1	0	0	2
OG0010878	1	0	1	0	0	2
OG0010879	1	0	1	0	0	2
OG0010880	1	0	1	0	0	2
OG0010881	1	1	0	0	0	2
OG0010882	2	0	0	0	0	2
OG0010883	1	0	1	0	0	2
OG0010884	1	0	1	0	0	2
OG0010885	2	0	0	0	0	2
OG0010886	2	0	0	0	0	2
OG0010887	2	0	0	0	0	2
OG0010888	2	0	0	0	0	2
OG0010889	2	0	0	0	0	2
OG0010890	2	0	0	0	0	2
OG0010891	1	0	0	0	1	2
OG0010892	1	0	1	0	0	2
OG0010893	1	0	1	0	0	2
OG0010894	2	0	0	0	0	2
OG0010895	1	0	1	0	0	2
OG0010896	1	0	1	0	0	2
OG0010897	1	0	1	0	0	2
OG0010898	1	0	1	0	0	2
OG0010899	2	0	0	0	0	2
OG0010900	1	0	1	0	0	2
OG0010901	2	0	0	0	0	2
OG0010902	1	0	1	0	0	2
OG0010903	2	0	0	0	0	2
OG0010904	1	0	1	0	0	2
OG0010905	2	0	0	0	0	2
OG0010906	2	0	0	0	0	2
OG0010907	1	0	1	0	0	2
OG0010908	1	0	1	0	0	2
OG0010909	1	0	0	0	1	2
OG0010910	1	0	1	0	0	2
OG0010911	1	0	1	0	0	2
OG0010912	1	0	0	0	1	2
OG0010913	1	0	1	0	0	2
OG0010914	1	0	0	0	1	2
OG0010915	1	0	1	0	0	2
OG0010916	0	1	0	1	0	2
OG0010917	0	1	0	1	0	2
OG0010918	0	1	0	1	0	2
OG0010919	0	1	0	1	0	2
OG0010920	0	1	0	1	0	2
OG0010921	0	1	0	1	0	2
OG0010922	0	1	0	1	0	2
OG0010923	0	2	0	0	0	2
OG0010924	0	1	0	1	0	2
OG0010925	0	1	0	1	0	2
OG0010926	0	1	0	1	0	2
OG0010927	0	1	0	1	0	2
OG0010928	0	1	0	1	0	2
OG0010929	0	1	0	1	0	2
OG0010930	0	1	0	1	0	2
OG0010931	0	1	0	1	0	2
OG0010932	0	1	0	1	0	2
OG0010933	0	1	0	1	0	2
OG0010934	0	1	0	1	0	2
OG0010935	0	1	0	1	0	2
OG0010936	0	1	0	1	0	2
OG0010937	0	1	0	1	0	2
OG0010938	0	1	0	1	0	2
OG0010939	0	1	0	1	0	2
OG0010940	0	1	0	1	0	2
OG0010941	0	1	1	0	0	2
OG0010942	0	2	0	0	0	2
OG0010943	0	1	0	1	0	2
OG0010944	0	1	0	1	0	2
OG0010945	0	1	0	1	0	2
OG0010946	0	1	0	1	0	2
OG0010947	0	2	0	0	0	2
OG0010948	0	1	0	1	0	2
OG0010949	0	1	0	1	0	2
OG0010950	0	1	0	1	0	2
OG0010951	0	1	0	1	0	2
OG0010952	0	1	0	1	0	2
OG0010953	0	1	1	0	0	2
OG0010954	0	1	0	1	0	2
OG0010955	0	1	0	1	0	2
OG0010956	0	1	0	1	0	2
OG0010957	0	1	1	0	0	2
OG0010958	0	2	0	0	0	2
OG0010959	0	1	0	1	0	2
OG0010960	0	1	0	1	0	2
OG0010961	0	1	1	0	0	2
OG0010962	0	1	0	1	0	2
OG0010963	0	1	0	1	0	2
OG0010964	0	1	0	1	0	2
OG0010965	0	1	0	1	0	2
OG0010966	0	1	0	1	0	2
OG0010967	0	1	0	1	0	2
OG0010968	0	1	0	1	0	2
OG0010969	0	1	1	0	0	2
OG0010970	0	1	0	1	0	2
OG0010971	0	1	0	1	0	2
OG0010972	0	1	0	1	0	2
OG0010973	0	1	0	1	0	2
OG0010974	0	1	0	1	0	2
OG0010975	0	1	0	1	0	2
OG0010976	0	1	0	1	0	2
OG0010977	0	1	0	1	0	2
OG0010978	0	1	0	1	0	2
OG0010979	0	1	0	1	0	2
OG0010980	0	1	0	1	0	2
OG0010981	0	2	0	0	0	2
OG0010982	0	1	0	1	0	2
OG0010983	0	1	0	1	0	2
OG0010984	0	1	0	1	0	2
OG0010985	0	1	0	1	0	2
OG0010986	0	1	0	1	0	2
OG0010987	0	1	0	1	0	2
OG0010988	0	1	0	1	0	2
OG0010989	0	1	0	1	0	2
OG0010990	0	1	0	1	0	2
OG0010991	0	1	0	1	0	2
OG0010992	0	2	0	0	0	2
OG0010993	0	1	0	1	0	2
OG0010994	0	1	0	1	0	2
OG0010995	0	1	0	1	0	2
OG0010996	0	1	0	1	0	2
OG0010997	0	1	0	1	0	2
OG0010998	0	1	0	1	0	2
OG0010999	0	1	0	1	0	2
OG0011000	0	1	0	1	0	2
OG0011001	0	1	1	0	0	2
OG0011002	0	1	0	1	0	2
OG0011003	0	1	0	1	0	2
OG0011004	0	1	0	1	0	2
OG0011005	0	1	0	1	0	2
OG0011006	0	1	0	1	0	2
OG0011007	0	1	0	1	0	2
OG0011008	0	1	0	1	0	2
OG0011009	0	1	0	1	0	2
OG0011010	0	1	0	1	0	2
OG0011011	0	1	0	1	0	2
OG0011012	0	1	0	1	0	2
OG0011013	0	1	0	1	0	2
OG0011014	0	1	0	1	0	2
OG0011015	0	1	0	1	0	2
OG0011016	0	1	0	1	0	2
OG0011017	0	1	1	0	0	2
OG0011018	0	1	0	1	0	2
OG0011019	0	2	0	0	0	2
OG0011020	0	1	0	1	0	2
OG0011021	0	1	0	0	1	2
OG0011022	0	2	0	0	0	2
OG0011023	0	1	0	1	0	2
OG0011024	0	2	0	0	0	2
OG0011025	0	1	0	1	0	2
OG0011026	0	1	0	1	0	2
OG0011027	0	1	0	1	0	2
OG0011028	0	2	0	0	0	2
OG0011029	0	1	0	1	0	2
OG0011030	0	1	0	1	0	2
OG0011031	0	1	0	1	0	2
OG0011032	0	1	0	1	0	2
OG0011033	0	1	0	1	0	2
OG0011034	0	1	0	1	0	2
OG0011035	0	1	0	1	0	2
OG0011036	0	1	0	1	0	2
OG0011037	0	1	0	1	0	2
OG0011038	0	1	0	1	0	2
OG0011039	0	1	0	1	0	2
OG0011040	0	1	0	1	0	2
OG0011041	0	2	0	0	0	2
OG0011042	0	1	0	1	0	2
OG0011043	0	1	0	1	0	2
OG0011044	0	1	0	1	0	2
OG0011045	0	1	0	1	0	2
OG0011046	0	1	0	1	0	2
OG0011047	0	1	1	0	0	2
OG0011048	0	1	0	1	0	2
OG0011049	0	2	0	0	0	2
OG0011050	0	1	0	1	0	2
OG0011051	0	1	0	1	0	2
OG0011052	0	1	0	1	0	2
OG0011053	0	1	0	1	0	2
OG0011054	0	1	0	1	0	2
OG0011055	0	1	0	1	0	2
OG0011056	0	1	0	1	0	2
OG0011057	0	1	0	1	0	2
OG0011058	0	1	0	1	0	2
OG0011059	0	1	0	1	0	2
OG0011060	0	1	0	1	0	2
OG0011061	0	1	0	1	0	2
OG0011062	0	1	0	1	0	2
OG0011063	0	1	0	1	0	2
OG0011064	0	1	0	1	0	2
OG0011065	0	2	0	0	0	2
OG0011066	0	1	0	1	0	2
OG0011067	0	1	0	1	0	2
OG0011068	0	1	1	0	0	2
OG0011069	0	1	0	1	0	2
OG0011070	0	1	0	1	0	2
OG0011071	0	1	0	1	0	2
OG0011072	0	1	0	1	0	2
OG0011073	0	1	0	1	0	2
OG0011074	0	2	0	0	0	2
OG0011075	0	1	0	1	0	2
OG0011076	0	1	0	1	0	2
OG0011077	0	1	0	1	0	2
OG0011078	0	1	0	1	0	2
OG0011079	0	1	0	1	0	2
OG0011080	0	2	0	0	0	2
OG0011081	0	1	0	1	0	2
OG0011082	0	1	0	1	0	2
OG0011083	0	1	1	0	0	2
OG0011084	0	1	0	1	0	2
OG0011085	0	1	0	0	1	2
OG0011086	0	2	0	0	0	2
OG0011087	0	1	0	1	0	2
OG0011088	0	2	0	0	0	2
OG0011089	0	1	0	1	0	2
OG0011090	0	2	0	0	0	2
OG0011091	0	2	0	0	0	2
OG0011092	0	2	0	0	0	2
OG0011093	0	1	1	0	0	2
OG0011094	0	1	0	1	0	2
OG0011095	0	1	0	1	0	2
OG0011096	0	1	0	1	0	2
OG0011097	0	1	0	1	0	2
OG0011098	0	1	0	1	0	2
OG0011099	0	1	0	1	0	2
OG0011100	0	1	0	1	0	2
OG0011101	0	1	1	0	0	2
OG0011102	0	1	1	0	0	2
OG0011103	0	2	0	0	0	2
OG0011104	0	1	0	1	0	2
OG0011105	0	1	0	1	0	2
OG0011106	0	1	0	1	0	2
OG0011107	0	1	0	1	0	2
OG0011108	0	1	0	1	0	2
OG0011109	0	1	0	1	0	2
OG0011110	0	1	0	1	0	2
OG0011111	0	1	1	0	0	2
OG0011112	0	1	1	0	0	2
OG0011113	0	1	0	1	0	2
OG0011114	0	1	0	1	0	2
OG0011115	0	1	0	1	0	2
OG0011116	0	1	0	1	0	2
OG0011117	0	1	1	0	0	2
OG0011118	0	1	0	1	0	2
OG0011119	0	1	0	1	0	2
OG0011120	0	1	0	1	0	2
OG0011121	0	1	0	1	0	2
OG0011122	0	1	0	1	0	2
OG0011123	0	1	1	0	0	2
OG0011124	0	1	0	1	0	2
OG0011125	0	1	0	1	0	2
OG0011126	0	1	0	1	0	2
OG0011127	0	1	1	0	0	2
OG0011128	0	1	0	1	0	2
OG0011129	0	1	0	1	0	2
OG0011130	0	1	0	1	0	2
OG0011131	0	1	0	1	0	2
OG0011132	0	1	1	0	0	2
OG0011133	0	1	0	1	0	2
OG0011134	0	1	0	1	0	2
OG0011135	0	1	0	1	0	2
OG0011136	0	1	0	1	0	2
OG0011137	0	1	0	1	0	2
OG0011138	0	1	0	1	0	2
OG0011139	0	1	0	1	0	2
OG0011140	0	1	0	1	0	2
OG0011141	0	1	0	1	0	2
OG0011142	0	1	0	1	0	2
OG0011143	0	1	0	1	0	2
OG0011144	0	1	0	1	0	2
OG0011145	0	1	0	1	0	2
OG0011146	0	1	0	1	0	2
OG0011147	0	1	0	1	0	2
OG0011148	0	1	0	1	0	2
OG0011149	0	1	0	1	0	2
OG0011150	0	1	0	1	0	2
OG0011151	0	2	0	0	0	2
OG0011152	0	1	0	1	0	2
OG0011153	0	2	0	0	0	2
OG0011154	0	1	1	0	0	2
OG0011155	0	1	0	1	0	2
OG0011156	0	1	0	1	0	2
OG0011157	0	1	0	1	0	2
OG0011158	0	1	1	0	0	2
OG0011159	0	0	1	0	1	2
OG0011160	0	0	1	1	0	2
OG0011161	0	0	1	0	1	2
OG0011162	0	0	1	0	1	2
OG0011163	0	0	1	1	0	2
OG0011164	0	0	2	0	0	2
OG0011165	0	0	1	0	1	2
OG0011166	0	0	1	0	1	2
OG0011167	0	0	1	1	0	2
OG0011168	0	0	1	1	0	2
OG0011169	0	0	1	1	0	2
OG0011170	0	0	1	1	0	2
OG0011171	0	0	1	1	0	2
OG0011172	0	0	1	1	0	2
OG0011173	0	0	1	1	0	2
OG0011174	0	0	1	0	1	2
OG0011175	0	0	1	1	0	2
OG0011176	0	0	1	1	0	2
OG0011177	0	0	1	1	0	2
OG0011178	0	0	1	0	1	2
OG0011179	0	0	1	1	0	2
OG0011180	0	0	1	0	1	2
OG0011181	0	0	1	0	1	2
OG0011182	0	0	2	0	0	2
OG0011183	0	0	1	0	1	2
OG0011184	0	0	1	0	1	2
OG0011185	0	0	1	1	0	2
OG0011186	0	0	1	0	1	2
OG0011187	0	0	1	0	1	2
OG0011188	0	0	1	0	1	2
OG0011189	0	0	1	1	0	2
OG0011190	0	0	1	0	1	2
OG0011191	0	0	2	0	0	2
OG0011192	0	0	1	0	1	2
OG0011193	0	0	1	1	0	2
OG0011194	0	0	2	0	0	2
OG0011195	0	0	1	0	1	2
OG0011196	0	0	1	0	1	2
OG0011197	0	0	1	0	1	2
OG0011198	0	0	1	1	0	2
OG0011199	0	0	1	1	0	2
OG0011200	0	0	1	1	0	2
OG0011201	0	0	1	1	0	2
OG0011202	0	0	1	0	1	2
OG0011203	0	0	1	0	1	2
OG0011204	0	0	1	1	0	2
OG0011205	0	0	1	1	0	2
OG0011206	0	0	2	0	0	2
OG0011207	0	0	1	0	1	2
OG0011208	0	0	1	1	0	2
OG0011209	0	0	1	0	1	2
OG0011210	0	0	1	1	0	2
OG0011211	0	0	2	0	0	2
OG0011212	0	0	2	0	0	2
OG0011213	0	0	2	0	0	2
OG0011214	0	0	2	0	0	2
OG0011215	0	0	1	0	1	2
OG0011216	0	0	2	0	0	2
OG0011217	0	0	1	0	1	2
OG0011218	0	0	1	0	1	2
OG0011219	0	0	1	0	1	2
OG0011220	0	0	1	1	0	2
OG0011221	0	0	1	1	0	2
OG0011222	0	0	1	1	0	2
OG0011223	0	0	2	0	0	2
OG0011224	0	0	1	0	1	2
OG0011225	0	0	1	0	1	2
OG0011226	0	0	2	0	0	2
OG0011227	0	0	1	0	1	2
OG0011228	0	0	1	1	0	2
OG0011229	0	0	1	1	0	2
OG0011230	0	0	1	0	1	2
OG0011231	0	0	1	0	1	2
OG0011232	0	0	1	0	1	2
OG0011233	0	0	1	1	0	2
OG0011234	0	0	1	1	0	2
OG0011235	0	0	1	1	0	2
OG0011236	0	0	2	0	0	2
OG0011237	0	0	2	0	0	2
OG0011238	0	0	1	1	0	2
OG0011239	0	0	1	0	1	2
OG0011240	0	0	1	1	0	2
OG0011241	0	0	1	0	1	2
OG0011242	0	0	2	0	0	2
OG0011243	0	0	1	1	0	2
OG0011244	0	0	1	1	0	2
OG0011245	0	0	1	0	1	2
OG0011246	0	0	1	1	0	2
OG0011247	0	0	2	0	0	2
OG0011248	0	0	1	1	0	2
OG0011249	0	0	1	0	1	2
OG0011250	0	0	1	1	0	2
OG0011251	0	0	2	0	0	2
OG0011252	0	0	1	1	0	2
OG0011253	0	0	1	0	1	2
OG0011254	0	0	1	1	0	2
OG0011255	0	0	2	0	0	2
OG0011256	0	0	2	0	0	2
OG0011257	0	0	1	0	1	2
OG0011258	0	0	1	1	0	2
OG0011259	0	0	1	0	1	2
OG0011260	0	0	1	1	0	2
OG0011261	0	0	1	0	1	2
OG0011262	0	0	1	0	1	2
OG0011263	0	0	1	1	0	2
OG0011264	0	0	1	0	1	2
OG0011265	0	0	1	0	1	2
OG0011266	0	0	1	0	1	2
OG0011267	0	0	1	0	1	2
OG0011268	0	0	1	1	0	2
OG0011269	0	0	1	0	1	2
OG0011270	0	0	1	0	1	2
OG0011271	0	0	1	0	1	2
OG0011272	0	0	1	0	1	2
OG0011273	0	0	1	1	0	2
OG0011274	0	0	2	0	0	2
OG0011275	0	0	1	0	1	2
OG0011276	0	0	1	0	1	2
OG0011277	0	0	1	1	0	2
OG0011278	0	0	2	0	0	2
OG0011279	0	0	1	0	1	2
OG0011280	0	0	2	0	0	2
OG0011281	0	0	2	0	0	2
OG0011282	0	0	1	1	0	2
OG0011283	0	0	2	0	0	2
OG0011284	0	0	1	0	1	2
OG0011285	0	0	1	1	0	2
OG0011286	0	0	1	0	1	2
OG0011287	0	0	1	1	0	2
OG0011288	0	0	1	1	0	2
OG0011289	0	0	1	1	0	2
OG0011290	0	0	1	1	0	2
OG0011291	0	0	1	1	0	2
OG0011292	0	0	1	1	0	2
OG0011293	0	0	1	0	1	2
OG0011294	0	0	1	1	0	2
OG0011295	0	0	2	0	0	2
OG0011296	0	0	1	1	0	2
OG0011297	0	0	1	0	1	2
OG0011298	0	0	1	0	1	2
OG0011299	0	0	1	0	1	2
OG0011300	0	0	2	0	0	2
OG0011301	0	0	1	0	1	2
OG0011302	0	0	1	1	0	2
OG0011303	0	0	1	0	1	2
OG0011304	0	0	1	1	0	2
OG0011305	0	0	1	1	0	2
OG0011306	0	0	1	1	0	2
OG0011307	0	0	2	0	0	2
OG0011308	0	0	1	0	1	2
OG0011309	0	0	1	0	1	2
OG0011310	0	0	1	1	0	2
OG0011311	0	0	2	0	0	2
OG0011312	0	0	1	0	1	2
OG0011313	0	0	2	0	0	2
OG0011314	0	0	1	1	0	2
OG0011315	0	0	2	0	0	2
OG0011316	0	0	1	0	1	2
OG0011317	0	0	1	1	0	2
OG0011318	0	0	1	1	0	2
OG0011319	0	0	1	1	0	2
OG0011320	0	0	2	0	0	2
OG0011321	0	0	1	1	0	2
OG0011322	0	0	1	0	1	2
OG0011323	0	0	1	1	0	2
OG0011324	0	0	1	0	1	2
OG0011325	0	0	2	0	0	2
OG0011326	0	0	1	0	1	2
OG0011327	0	0	1	0	1	2
OG0011328	0	0	1	1	0	2
OG0011329	0	0	1	1	0	2
OG0011330	0	0	1	1	0	2
OG0011331	0	0	1	0	1	2
OG0011332	0	0	2	0	0	2
OG0011333	0	0	1	0	1	2
OG0011334	0	0	1	1	0	2
OG0011335	0	0	1	0	1	2
OG0011336	0	0	1	1	0	2
OG0011337	0	0	1	0	1	2
OG0011338	0	0	1	0	1	2
OG0011339	0	0	1	0	1	2
OG0011340	0	0	2	0	0	2
OG0011341	0	0	1	1	0	2
OG0011342	0	0	1	0	1	2
OG0011343	0	0	2	0	0	2
OG0011344	0	0	1	1	0	2
OG0011345	0	0	1	0	1	2
OG0011346	0	0	1	1	0	2
OG0011347	0	0	1	1	0	2
OG0011348	0	0	1	1	0	2
OG0011349	0	0	1	1	0	2
OG0011350	0	0	1	1	0	2
OG0011351	0	0	1	0	1	2
OG0011352	0	0	2	0	0	2
OG0011353	0	0	1	0	1	2
OG0011354	0	0	2	0	0	2
OG0011355	0	0	1	1	0	2
OG0011356	0	0	1	1	0	2
OG0011357	0	0	1	1	0	2
OG0011358	0	0	1	0	1	2
OG0011359	0	0	1	0	1	2
OG0011360	0	0	1	1	0	2
OG0011361	0	0	1	1	0	2
OG0011362	0	0	1	1	0	2
OG0011363	0	0	1	0	1	2
OG0011364	0	0	1	0	1	2
OG0011365	0	0	1	0	1	2
OG0011366	0	0	1	0	1	2
OG0011367	0	0	2	0	0	2
OG0011368	0	0	1	1	0	2
OG0011369	0	0	1	0	1	2
OG0011370	0	0	1	1	0	2
OG0011371	0	0	1	1	0	2
OG0011372	0	0	2	0	0	2
OG0011373	0	0	1	0	1	2
OG0011374	0	0	2	0	0	2
OG0011375	0	0	1	1	0	2
OG0011376	0	0	1	1	0	2
OG0011377	0	0	1	0	1	2
OG0011378	0	0	1	1	0	2
OG0011379	0	0	1	1	0	2
OG0011380	0	0	1	1	0	2
OG0011381	0	0	2	0	0	2
OG0011382	0	0	1	1	0	2
OG0011383	0	0	1	0	1	2
OG0011384	0	0	1	0	1	2
OG0011385	0	0	1	1	0	2
OG0011386	0	0	1	1	0	2
OG0011387	0	0	1	1	0	2
OG0011388	0	0	2	0	0	2
OG0011389	0	0	1	0	1	2
OG0011390	0	0	1	1	0	2
OG0011391	0	0	1	1	0	2
OG0011392	0	0	1	1	0	2
OG0011393	0	0	1	0	1	2
OG0011394	0	0	1	0	1	2
OG0011395	0	0	1	1	0	2
OG0011396	0	0	1	1	0	2
OG0011397	0	0	2	0	0	2
OG0011398	0	0	1	1	0	2
OG0011399	0	0	1	0	1	2
OG0011400	0	0	1	0	1	2
OG0011401	0	0	2	0	0	2
OG0011402	0	0	1	1	0	2
OG0011403	0	0	1	0	1	2
OG0011404	0	0	1	1	0	2
OG0011405	0	0	2	0	0	2
OG0011406	0	0	1	0	1	2
OG0011407	0	0	1	1	0	2
OG0011408	0	0	1	1	0	2
OG0011409	0	0	1	0	1	2
OG0011410	0	0	1	0	1	2
OG0011411	0	0	1	0	1	2
OG0011412	0	0	1	1	0	2
OG0011413	0	0	1	0	1	2
OG0011414	0	0	1	0	1	2
OG0011415	0	0	1	0	1	2
OG0011416	0	0	1	0	1	2
OG0011417	0	0	1	1	0	2
OG0011418	0	0	1	1	0	2
OG0011419	0	0	0	2	0	2
OG0011420	0	0	0	2	0	2
OG0011421	0	0	0	2	0	2
OG0011422	0	0	0	2	0	2
OG0011423	0	0	0	1	1	2
OG0011424	0	0	0	2	0	2
OG0011425	0	0	0	2	0	2
OG0011426	0	0	0	2	0	2
OG0011427	0	0	0	1	1	2
OG0011428	0	0	0	2	0	2
OG0011429	0	0	0	2	0	2
OG0011430	0	0	0	2	0	2
OG0011431	0	0	0	1	1	2
OG0011432	0	0	0	2	0	2
OG0011433	0	0	0	1	1	2
OG0011434	0	0	0	2	0	2
OG0011435	0	0	0	2	0	2
OG0011436	0	0	0	2	0	2
OG0011437	0	0	0	2	0	2
OG0011438	0	0	0	2	0	2
OG0011439	0	0	0	2	0	2
OG0011440	0	0	0	1	1	2
OG0011441	0	0	0	2	0	2
OG0011442	0	0	0	2	0	2
OG0011443	0	0	0	2	0	2
OG0011444	0	0	0	2	0	2
OG0011445	0	0	0	2	0	2
OG0011446	0	0	0	2	0	2
OG0011447	0	0	0	1	1	2
OG0011448	0	0	0	2	0	2
OG0011449	0	0	0	2	0	2
OG0011450	0	0	0	2	0	2
OG0011451	0	0	0	2	0	2
OG0011452	0	0	0	2	0	2
OG0011453	0	0	0	2	0	2
OG0011454	0	0	0	2	0	2
OG0011455	0	0	0	2	0	2
OG0011456	0	0	0	2	0	2
OG0011457	0	0	0	2	0	2
OG0011458	0	0	0	2	0	2
OG0011459	0	0	0	2	0	2
OG0011460	0	0	0	2	0	2
OG0011461	0	0	0	2	0	2
OG0011462	0	0	0	2	0	2
OG0011463	0	0	0	1	1	2
OG0011464	0	0	0	2	0	2
OG0011465	0	0	0	1	1	2
OG0011466	0	0	0	2	0	2
OG0011467	0	0	0	1	1	2
OG0011468	0	0	0	2	0	2
OG0011469	0	0	0	2	0	2
OG0011470	0	0	0	1	1	2
OG0011471	0	0	0	2	0	2
OG0011472	0	0	0	1	1	2
OG0011473	0	0	0	2	0	2
OG0011474	0	0	0	1	1	2
OG0011475	0	0	0	1	1	2
OG0011476	0	0	0	1	1	2
OG0011477	0	0	0	1	1	2
OG0011478	0	0	0	2	0	2
OG0011479	0	0	0	1	1	2
OG0011480	0	0	0	1	1	2
OG0011481	0	0	0	2	0	2
OG0011482	0	0	0	1	1	2
OG0011483	0	0	0	2	0	2
OG0011484	0	0	0	2	0	2
OG0011485	0	0	0	0	2	2
OG0011486	0	0	0	0	2	2
OG0011487	0	0	0	0	2	2
OG0011488	0	0	0	0	2	2
OG0011489	0	0	0	0	2	2
OG0011490	0	0	0	0	2	2
OG0011491	0	0	0	0	2	2
OG0011492	0	0	0	0	2	2
OG0011493	0	0	0	0	2	2
OG0011494	0	0	0	0	2	2
OG0011495	0	0	0	0	2	2
OG0011496	0	0	0	0	2	2
OG0011497	0	0	0	0	2	2
OG0011498	0	0	0	0	2	2
OG0011499	0	0	0	0	2	2
OG0011500	0	0	0	0	2	2
OG0011501	0	0	0	0	2	2
OG0011502	0	0	0	0	2	2
OG0011503	0	0	0	0	2	2
OG0011504	0	0	0	0	2	2
OG0011505	0	0	0	0	2	2
OG0011506	0	0	0	0	2	2
OG0011507	0	0	0	0	2	2
OG0011508	0	0	0	0	2	2
OG0011509	0	0	0	0	2	2
OG0011510	0	0	0	0	2	2
OG0011511	0	0	0	0	2	2
OG0011512	0	0	0	0	2	2
OG0011513	0	0	0	0	2	2
OG0011514	0	0	0	0	2	2
OG0011515	0	0	0	0	2	2
OG0011516	0	0	0	0	2	2
OG0011517	0	0	0	0	2	2
OG0011518	0	0	0	0	2	2
OG0011519	0	0	0	0	2	2
